Geo_NAME,Geo_QName,Geo_SUMLEV,Geo_GEOCOMP,Geo_REGION,Geo_DIVISION,Geo_FIPS,Geo_STATE,Geo_COUNTY,SE_T110_001,SE_T110_002,SE_T110_003,SE_T110_004,SE_T110_005
"Autauga County","Autauga County, Alabama","050","00","3","6","01001","01","001",34222,33881,341,216,125
"Baldwin County","Baldwin County, Alabama","050","00","3","6","01003","01","003",98280,97305,975,663,312
"Barbour County","Barbour County, Alabama","050","00","3","6","01005","01","005",25417,25335,82,71,11
"Bibb County","Bibb County, Alabama","050","00","3","6","01007","01","007",16576,16558,18,9,9
"Blount County","Blount County, Alabama","050","00","3","6","01009","01","009",39248,39001,247,108,139
"Bullock County","Bullock County, Alabama","050","00","3","6","01011","01","011",11042,11018,24,24,0
"Butler County","Butler County, Alabama","050","00","3","6","01013","01","013",21892,21842,50,39,11
"Calhoun County","Calhoun County, Alabama","050","00","3","6","01015","01","015",116034,114572,1462,865,597
"Chambers County","Chambers County, Alabama","050","00","3","6","01017","01","017",36876,36783,93,40,53
"Cherokee County","Cherokee County, Alabama","050","00","3","6","01019","01","019",19543,19496,47,30,17
"Chilton County","Chilton County, Alabama","050","00","3","6","01021","01","021",32458,32328,130,72,58
"Choctaw County","Choctaw County, Alabama","050","00","3","6","01023","01","023",16018,15984,34,18,16
"Clarke County","Clarke County, Alabama","050","00","3","6","01025","01","025",27240,27144,96,71,25
"Clay County","Clay County, Alabama","050","00","3","6","01027","01","027",13252,13208,44,19,25
"Cleburne County","Cleburne County, Alabama","050","00","3","6","01029","01","029",12730,12706,24,12,12
"Coffee County","Coffee County, Alabama","050","00","3","6","01031","01","031",40240,39490,750,450,300
"Colbert County","Colbert County, Alabama","050","00","3","6","01033","01","033",51666,51503,163,74,89
"Conecuh County","Conecuh County, Alabama","050","00","3","6","01035","01","035",14054,14038,16,10,6
"Coosa County","Coosa County, Alabama","050","00","3","6","01037","01","037",11063,11040,23,21,2
"Covington County","Covington County, Alabama","050","00","3","6","01039","01","039",36478,36279,199,91,108
"Crenshaw County","Crenshaw County, Alabama","050","00","3","6","01041","01","041",13635,13586,49,27,22
"Cullman County","Cullman County, Alabama","050","00","3","6","01043","01","043",67613,67409,204,126,78
"Dale County","Dale County, Alabama","050","00","3","6","01045","01","045",49633,48214,1419,851,568
"Dallas County","Dallas County, Alabama","050","00","3","6","01047","01","047",48130,47927,203,79,124
"DeKalb County","DeKalb County, Alabama","050","00","3","6","01049","01","049",54651,54451,200,121,79
"Elmore County","Elmore County, Alabama","050","00","3","6","01051","01","051",49210,48803,407,313,94
"Escambia County","Escambia County, Alabama","050","00","3","6","01053","01","053",35518,35418,100,80,20
"Etowah County","Etowah County, Alabama","050","00","3","6","01055","01","055",99840,99058,782,253,529
"Fayette County","Fayette County, Alabama","050","00","3","6","01057","01","057",17962,17900,62,43,19
"Franklin County","Franklin County, Alabama","050","00","3","6","01059","01","059",27814,27760,54,28,26
"Geneva County","Geneva County, Alabama","050","00","3","6","01061","01","061",23647,23512,135,74,61
"Greene County","Greene County, Alabama","050","00","3","6","01063","01","063",10153,10143,10,0,10
"Hale County","Hale County, Alabama","050","00","3","6","01065","01","065",15498,15480,18,18,0
"Henry County","Henry County, Alabama","050","00","3","6","01067","01","067",15374,15299,75,35,40
"Houston County","Houston County, Alabama","050","00","3","6","01069","01","069",81331,80644,687,432,255
"Jackson County","Jackson County, Alabama","050","00","3","6","01071","01","071",47796,47609,187,121,66
"Jefferson County","Jefferson County, Alabama","050","00","3","6","01073","01","073",651525,644000,7525,3392,4133
"Lamar County","Lamar County, Alabama","050","00","3","6","01075","01","075",15715,15670,45,33,12
"Lauderdale County","Lauderdale County, Alabama","050","00","3","6","01077","01","077",79661,79307,354,209,145
"Lawrence County","Lawrence County, Alabama","050","00","3","6","01079","01","079",31513,31473,40,13,27
"Lee County","Lee County, Alabama","050","00","3","6","01081","01","081",87146,85140,2006,578,1428
"Limestone County","Limestone County, Alabama","050","00","3","6","01083","01","083",54135,53788,347,255,92
"Lowndes County","Lowndes County, Alabama","050","00","3","6","01085","01","085",12658,12632,26,20,6
"Macon County","Macon County, Alabama","050","00","3","6","01087","01","087",24928,24648,280,43,237
"Madison County","Madison County, Alabama","050","00","3","6","01089","01","089",238912,231221,7691,3930,3761
"Marengo County","Marengo County, Alabama","050","00","3","6","01091","01","091",23084,23013,71,36,35
"Marion County","Marion County, Alabama","050","00","3","6","01093","01","093",29830,29766,64,23,41
"Marshall County","Marshall County, Alabama","050","00","3","6","01095","01","095",70832,70530,302,182,120
"Mobile County","Mobile County, Alabama","050","00","3","6","01097","01","097",378643,372651,5992,2643,3349
"Monroe County","Monroe County, Alabama","050","00","3","6","01099","01","099",23968,23881,87,39,48
"Montgomery County","Montgomery County, Alabama","050","00","3","6","01101","01","101",209085,205957,3128,1700,1428
"Morgan County","Morgan County, Alabama","050","00","3","6","01103","01","103",100043,99324,719,463,256
"Perry County","Perry County, Alabama","050","00","3","6","01105","01","105",12759,12663,96,87,9
"Pickens County","Pickens County, Alabama","050","00","3","6","01107","01","107",20699,20683,16,16,0
"Pike County","Pike County, Alabama","050","00","3","6","01109","01","109",27595,27357,238,99,139
"Randolph County","Randolph County, Alabama","050","00","3","6","01111","01","111",19881,19815,66,12,54
"Russell County","Russell County, Alabama","050","00","3","6","01113","01","113",46860,46320,540,287,253
"St. Clair County","St. Clair County, Alabama","050","00","3","6","01115","01","115",50009,49845,164,95,69
"Shelby County","Shelby County, Alabama","050","00","3","6","01117","01","117",99358,98153,1205,578,627
"Sumter County","Sumter County, Alabama","050","00","3","6","01119","01","119",16174,16114,60,10,50
"Talladega County","Talladega County, Alabama","050","00","3","6","01121","01","121",74107,73674,433,219,214
"Tallapoosa County","Tallapoosa County, Alabama","050","00","3","6","01123","01","123",38826,38672,154,128,26
"Tuscaloosa County","Tuscaloosa County, Alabama","050","00","3","6","01125","01","125",150522,148383,2139,637,1502
"Walker County","Walker County, Alabama","050","00","3","6","01127","01","127",67670,67434,236,104,132
"Washington County","Washington County, Alabama","050","00","3","6","01129","01","129",16694,16662,32,20,12
"Wilcox County","Wilcox County, Alabama","050","00","3","6","01131","01","131",13568,13562,6,0,6
"Winston County","Winston County, Alabama","050","00","3","6","01133","01","133",22053,21992,61,36,25
"Aleutians East Borough","Aleutians East Borough, Alaska","050","00","4","9","02013","02","013",2464,1896,568,148,420
"Aleutians West Census Area","Aleutians West Census Area, Alaska","050","00","4","9","02016","02","016",9478,8327,1151,402,749
"Anchorage Borough","Anchorage Borough, Alaska","050","00","4","9","02020","02","020",226338,212979,13359,7194,6165
"Bethel Census Area","Bethel Census Area, Alaska","050","00","4","9","02050","02","050",13656,13539,117,54,63
"Bristol Bay Borough","Bristol Bay Borough, Alaska","050","00","4","9","02060","02","060",1410,1389,21,12,9
"Dillingham Census Area","Dillingham Census Area, Alaska","050","00","4","9","02070","02","070",4012,3988,24,16,8
"Fairbanks North Star Borough","Fairbanks North Star Borough, Alaska","050","00","4","9","02090","02","090",77720,74824,2896,1583,1313
"Haines Borough","Haines Borough, Alaska","050","00","4","9","02100","02","100",2117,2064,53,22,31
"Juneau Borough","Juneau Borough, Alaska","050","00","4","9","02110","02","110",26751,25453,1298,703,595
"Kenai Peninsula Borough","Kenai Peninsula Borough, Alaska","050","00","4","9","02122","02","122",40802,39726,1076,697,379
"Ketchikan Gateway Borough","Ketchikan Gateway Borough, Alaska","050","00","4","9","02130","02","130",13828,13330,498,360,138
"Kodiak Island Borough","Kodiak Island Borough, Alaska","050","00","4","9","02150","02","150",13309,12005,1304,697,607
"Lake and Peninsula Borough","Lake and Peninsula Borough, Alaska","050","00","4","9","02164","02","164",1668,1633,35,12,23
"Matanuska-Susitna Borough","Matanuska-Susitna Borough, Alaska","050","00","4","9","02170","02","170",39683,38915,768,500,268
"Nome Census Area","Nome Census Area, Alaska","050","00","4","9","02180","02","180",8288,8181,107,62,45
"North Slope Borough","North Slope Borough, Alaska","050","00","4","9","02185","02","185",5979,5756,223,159,64
"Northwest Arctic Borough","Northwest Arctic Borough, Alaska","050","00","4","9","02188","02","188",6113,6084,29,18,11
"Prince of Wales-Outer Ketchikan Census Area","Prince of Wales-Outer Ketchikan Census Area, Alaska","050","00","4","9","02201","02","201",6278,6182,96,61,35
"Sitka Borough","Sitka Borough, Alaska","050","00","4","9","02220","02","220",8588,8265,323,178,145
"Skagway-Yakutat-Angoon Census Area","Skagway-Yakutat-Angoon Census Area, Alaska","050","00","4","9","02231","02","231",4385,4284,101,45,56
"Southeast Fairbanks Census Area","Southeast Fairbanks Census Area, Alaska","050","00","4","9","02240","02","240",5913,5737,176,101,75
"Valdez-Cordova Census Area","Valdez-Cordova Census Area, Alaska","050","00","4","9","02261","02","261",9952,9609,343,178,165
"Wade Hampton Census Area","Wade Hampton Census Area, Alaska","050","00","4","9","02270","02","270",5791,5763,28,10,18
"Wrangell-Petersburg Census Area","Wrangell-Petersburg Census Area, Alaska","050","00","4","9","02280","02","280",7042,6951,91,70,21
"Yukon-Koyukuk Census Area","Yukon-Koyukuk Census Area, Alaska","050","00","4","9","02290","02","290",8478,8349,129,83,46
"Apache County","Apache County, Arizona","050","00","4","8","04001","04","001",61591,61265,326,148,178
"Cochise County","Cochise County, Arizona","050","00","4","8","04003","04","003",97624,86501,11123,5067,6056
"Coconino County","Coconino County, Arizona","050","00","4","8","04005","04","005",96591,93887,2704,1092,1612
"Gila County","Gila County, Arizona","050","00","4","8","04007","04","007",40216,39106,1110,848,262
"Graham County","Graham County, Arizona","050","00","4","8","04009","04","009",26554,25700,854,333,521
"Greenlee County","Greenlee County, Arizona","050","00","4","8","04011","04","011",8008,7750,258,122,136
"La Paz County","La Paz County, Arizona","050","00","4","8","04012","04","012",13844,12229,1615,453,1162
"Maricopa County","Maricopa County, Arizona","050","00","4","8","04013","04","013",2122101,1967220,154881,61608,93273
"Mohave County","Mohave County, Arizona","050","00","4","8","04015","04","015",93497,90108,3389,1945,1444
"Navajo County","Navajo County, Arizona","050","00","4","8","04017","04","017",77658,76936,722,361,361
"Pima County","Pima County, Arizona","050","00","4","8","04019","04","019",666880,606932,59948,25470,34478
"Pinal County","Pinal County, Arizona","050","00","4","8","04021","04","021",116379,109430,6949,2585,4364
"Santa Cruz County","Santa Cruz County, Arizona","050","00","4","8","04023","04","023",29676,18885,10791,2975,7816
"Yavapai County","Yavapai County, Arizona","050","00","4","8","04025","04","025",107714,104326,3388,2022,1366
"Yuma County","Yuma County, Arizona","050","00","4","8","04027","04","027",106895,86748,20147,3849,16298
"Arkansas County","Arkansas County, Arkansas","050","00","3","7","05001","05","001",21653,21624,29,7,22
"Ashley County","Ashley County, Arkansas","050","00","3","7","05003","05","003",24319,24148,171,121,50
"Baxter County","Baxter County, Arkansas","050","00","3","7","05005","05","005",31186,30571,615,559,56
"Benton County","Benton County, Arkansas","050","00","3","7","05007","05","007",97499,96260,1239,659,580
"Boone County","Boone County, Arkansas","050","00","3","7","05009","05","009",28297,28165,132,84,48
"Bradley County","Bradley County, Arkansas","050","00","3","7","05011","05","011",11793,11733,60,22,38
"Calhoun County","Calhoun County, Arkansas","050","00","3","7","05013","05","013",5826,5809,17,15,2
"Carroll County","Carroll County, Arkansas","050","00","3","7","05015","05","015",18654,18506,148,87,61
"Chicot County","Chicot County, Arkansas","050","00","3","7","05017","05","017",15713,15616,97,22,75
"Clark County","Clark County, Arkansas","050","00","3","7","05019","05","019",21437,21234,203,65,138
"Clay County","Clay County, Arkansas","050","00","3","7","05021","05","021",18107,18062,45,22,23
"Cleburne County","Cleburne County, Arkansas","050","00","3","7","05023","05","023",19411,19260,151,77,74
"Cleveland County","Cleveland County, Arkansas","050","00","3","7","05025","05","025",7781,7735,46,28,18
"Columbia County","Columbia County, Arkansas","050","00","3","7","05027","05","027",25691,25438,253,142,111
"Conway County","Conway County, Arkansas","050","00","3","7","05029","05","029",19151,19058,93,49,44
"Craighead County","Craighead County, Arkansas","050","00","3","7","05031","05","031",68956,68405,551,142,409
"Crawford County","Crawford County, Arkansas","050","00","3","7","05033","05","033",42493,42066,427,146,281
"Crittenden County","Crittenden County, Arkansas","050","00","3","7","05035","05","035",49939,49647,292,186,106
"Cross County","Cross County, Arkansas","050","00","3","7","05037","05","037",19225,19165,60,48,12
"Dallas County","Dallas County, Arkansas","050","00","3","7","05039","05","039",9614,9574,40,8,32
"Desha County","Desha County, Arkansas","050","00","3","7","05041","05","041",16798,16620,178,84,94
"Drew County","Drew County, Arkansas","050","00","3","7","05043","05","043",17369,17301,68,40,28
"Faulkner County","Faulkner County, Arkansas","050","00","3","7","05045","05","045",60006,59569,437,166,271
"Franklin County","Franklin County, Arkansas","050","00","3","7","05047","05","047",14897,14828,69,43,26
"Fulton County","Fulton County, Arkansas","050","00","3","7","05049","05","049",10037,10015,22,20,2
"Garland County","Garland County, Arkansas","050","00","3","7","05051","05","051",73397,71962,1435,1079,356
"Grant County","Grant County, Arkansas","050","00","3","7","05053","05","053",13948,13850,98,36,62
"Greene County","Greene County, Arkansas","050","00","3","7","05055","05","055",31804,31706,98,34,64
"Hempstead County","Hempstead County, Arkansas","050","00","3","7","05057","05","057",21621,21397,224,119,105
"Hot Spring County","Hot Spring County, Arkansas","050","00","3","7","05059","05","059",26115,26002,113,48,65
"Howard County","Howard County, Arkansas","050","00","3","7","05061","05","061",13569,13540,29,9,20
"Independence County","Independence County, Arkansas","050","00","3","7","05063","05","063",31192,30970,222,130,92
"Izard County","Izard County, Arkansas","050","00","3","7","05065","05","065",11364,11259,105,59,46
"Jackson County","Jackson County, Arkansas","050","00","3","7","05067","05","067",18944,18903,41,33,8
"Jefferson County","Jefferson County, Arkansas","050","00","3","7","05069","05","069",85487,84980,507,260,247
"Johnson County","Johnson County, Arkansas","050","00","3","7","05071","05","071",18221,17960,261,148,113
"Lafayette County","Lafayette County, Arkansas","050","00","3","7","05073","05","073",9643,9616,27,16,11
"Lawrence County","Lawrence County, Arkansas","050","00","3","7","05075","05","075",17457,17405,52,27,25
"Lee County","Lee County, Arkansas","050","00","3","7","05077","05","077",13053,12971,82,61,21
"Lincoln County","Lincoln County, Arkansas","050","00","3","7","05079","05","079",13690,13624,66,16,50
"Little River County","Little River County, Arkansas","050","00","3","7","05081","05","081",13966,13879,87,26,61
"Logan County","Logan County, Arkansas","050","00","3","7","05083","05","083",20557,20409,148,77,71
"Lonoke County","Lonoke County, Arkansas","050","00","3","7","05085","05","085",39268,38939,329,165,164
"Madison County","Madison County, Arkansas","050","00","3","7","05087","05","087",11618,11558,60,37,23
"Marion County","Marion County, Arkansas","050","00","3","7","05089","05","089",12001,11845,156,136,20
"Miller County","Miller County, Arkansas","050","00","3","7","05091","05","091",38467,38181,286,142,144
"Mississippi County","Mississippi County, Arkansas","050","00","3","7","05093","05","093",57525,57072,453,196,257
"Monroe County","Monroe County, Arkansas","050","00","3","7","05095","05","095",11333,11320,13,13,0
"Montgomery County","Montgomery County, Arkansas","050","00","3","7","05097","05","097",7841,7796,45,45,0
"Nevada County","Nevada County, Arkansas","050","00","3","7","05099","05","099",10101,10090,11,11,0
"Newton County","Newton County, Arkansas","050","00","3","7","05101","05","101",7666,7633,33,20,13
"Ouachita County","Ouachita County, Arkansas","050","00","3","7","05103","05","103",30574,30439,135,68,67
"Perry County","Perry County, Arkansas","050","00","3","7","05105","05","105",7969,7945,24,23,1
"Phillips County","Phillips County, Arkansas","050","00","3","7","05107","05","107",28838,28720,118,105,13
"Pike County","Pike County, Arkansas","050","00","3","7","05109","05","109",10086,10031,55,23,32
"Poinsett County","Poinsett County, Arkansas","050","00","3","7","05111","05","111",24664,24606,58,22,36
"Polk County","Polk County, Arkansas","050","00","3","7","05113","05","113",17347,17120,227,100,127
"Pope County","Pope County, Arkansas","050","00","3","7","05115","05","115",45883,45619,264,185,79
"Prairie County","Prairie County, Arkansas","050","00","3","7","05117","05","117",9518,9507,11,8,3
"Pulaski County","Pulaski County, Arkansas","050","00","3","7","05119","05","119",349660,343609,6051,2971,3080
"Randolph County","Randolph County, Arkansas","050","00","3","7","05121","05","121",16558,16501,57,33,24
"St. Francis County","St. Francis County, Arkansas","050","00","3","7","05123","05","123",28497,28382,115,30,85
"Saline County","Saline County, Arkansas","050","00","3","7","05125","05","125",64183,63727,456,290,166
"Scott County","Scott County, Arkansas","050","00","3","7","05127","05","127",10205,10096,109,34,75
"Searcy County","Searcy County, Arkansas","050","00","3","7","05129","05","129",7841,7794,47,44,3
"Sebastian County","Sebastian County, Arkansas","050","00","3","7","05131","05","131",99590,96327,3263,996,2267
"Sevier County","Sevier County, Arkansas","050","00","3","7","05133","05","133",13637,13149,488,95,393
"Sharp County","Sharp County, Arkansas","050","00","3","7","05135","05","135",14109,13992,117,81,36
"Stone County","Stone County, Arkansas","050","00","3","7","05137","05","137",9775,9733,42,42,0
"Union County","Union County, Arkansas","050","00","3","7","05139","05","139",46719,46471,248,165,83
"Van Buren County","Van Buren County, Arkansas","050","00","3","7","05141","05","141",14008,13857,151,97,54
"Washington County","Washington County, Arkansas","050","00","3","7","05143","05","143",113409,111583,1826,674,1152
"White County","White County, Arkansas","050","00","3","7","05145","05","145",54676,54374,302,93,209
"Woodruff County","Woodruff County, Arkansas","050","00","3","7","05147","05","147",9520,9480,40,37,3
"Yell County","Yell County, Arkansas","050","00","3","7","05149","05","149",17759,17520,239,120,119
"Alameda County","Alameda County, California","050","00","4","9","06001","06","001",1279182,1048807,230375,89198,141177
"Alpine County","Alpine County, California","050","00","4","9","06003","06","003",1113,1095,18,9,9
"Amador County","Amador County, California","050","00","4","9","06005","06","005",30039,28920,1119,592,527
"Butte County","Butte County, California","050","00","4","9","06007","06","007",182120,171274,10846,3818,7028
"Calaveras County","Calaveras County, California","050","00","4","9","06009","06","009",31998,31068,930,619,311
"Colusa County","Colusa County, California","050","00","4","9","06011","06","011",16275,12912,3363,424,2939
"Contra Costa County","Contra Costa County, California","050","00","4","9","06013","06","013",803732,696672,107060,47777,59283
"Del Norte County","Del Norte County, California","050","00","4","9","06015","06","015",23460,21967,1493,498,995
"El Dorado County","El Dorado County, California","050","00","4","9","06017","06","017",125995,118233,7762,3284,4478
"Fresno County","Fresno County, California","050","00","4","9","06019","06","019",667490,548381,119109,28504,90605
"Glenn County","Glenn County, California","050","00","4","9","06021","06","021",24798,21569,3229,670,2559
"Humboldt County","Humboldt County, California","050","00","4","9","06023","06","023",119118,114502,4616,2376,2240
"Imperial County","Imperial County, California","050","00","4","9","06025","06","025",109303,77735,31568,7793,23775
"Inyo County","Inyo County, California","050","00","4","9","06027","06","027",18281,17425,856,327,529
"Kern County","Kern County, California","050","00","4","9","06029","06","029",543477,477336,66141,20383,45758
"Kings County","Kings County, California","050","00","4","9","06031","06","031",101469,87139,14330,4576,9754
"Lake County","Lake County, California","050","00","4","9","06033","06","033",50631,47936,2695,1273,1422
"Lassen County","Lassen County, California","050","00","4","9","06035","06","035",27598,26363,1235,364,871
"Los Angeles County","Los Angeles County, California","050","00","4","9","06037","06","037",8863164,5968098,2895066,792698,2102368
"Madera County","Madera County, California","050","00","4","9","06039","06","039",88090,74938,13152,3284,9868
"Marin County","Marin County, California","050","00","4","9","06041","06","041",230096,199607,30489,13009,17480
"Mariposa County","Mariposa County, California","050","00","4","9","06043","06","043",14302,13931,371,256,115
"Mendocino County","Mendocino County, California","050","00","4","9","06045","06","045",80345,74879,5466,1794,3672
"Merced County","Merced County, California","050","00","4","9","06047","06","047",178403,143046,35357,8161,27196
"Modoc County","Modoc County, California","050","00","4","9","06049","06","049",9678,9343,335,152,183
"Mono County","Mono County, California","050","00","4","9","06051","06","051",9956,8996,960,274,686
"Monterey County","Monterey County, California","050","00","4","9","06053","06","053",355660,278994,76666,23384,53282
"Napa County","Napa County, California","050","00","4","9","06055","06","055",110765,97800,12965,4278,8687
"Nevada County","Nevada County, California","050","00","4","9","06057","06","057",78510,75725,2785,1709,1076
"Orange County","Orange County, California","050","00","4","9","06059","06","059",2410556,1835448,575108,174444,400664
"Placer County","Placer County, California","050","00","4","9","06061","06","061",172796,164300,8496,4145,4351
"Plumas County","Plumas County, California","050","00","4","9","06063","06","063",19739,19220,519,316,203
"Riverside County","Riverside County, California","050","00","4","9","06065","06","065",1170413,996659,173754,53304,120450
"Sacramento County","Sacramento County, California","050","00","4","9","06067","06","067",1041219,937341,103878,41168,62710
"San Benito County","San Benito County, California","050","00","4","9","06069","06","069",36697,30430,6267,1492,4775
"San Bernardino County","San Bernardino County, California","050","00","4","9","06071","06","071",1418380,1231484,186896,59585,127311
"San Diego County","San Diego County, California","050","00","4","9","06073","06","073",2498016,2069206,428810,154960,273850
"San Francisco County","San Francisco County, California","050","00","4","9","06075","06","075",723959,477925,246034,103774,142260
"San Joaquin County","San Joaquin County, California","050","00","4","9","06077","06","077",480628,401997,78631,22669,55962
"San Luis Obispo County","San Luis Obispo County, California","050","00","4","9","06079","06","079",217162,200950,16212,6780,9432
"San Mateo County","San Mateo County, California","050","00","4","9","06081","06","081",649623,484856,164767,69896,94871
"Santa Barbara County","Santa Barbara County, California","050","00","4","9","06083","06","083",369608,307021,62587,18641,43946
"Santa Clara County","Santa Clara County, California","050","00","4","9","06085","06","085",1497577,1150376,347201,121409,225792
"Santa Cruz County","Santa Cruz County, California","050","00","4","9","06087","06","087",229734,197582,32152,9023,23129
"Shasta County","Shasta County, California","050","00","4","9","06089","06","089",147036,142847,4189,1937,2252
"Sierra County","Sierra County, California","050","00","4","9","06091","06","091",3318,3233,85,41,44
"Siskiyou County","Siskiyou County, California","050","00","4","9","06093","06","093",43531,41879,1652,896,756
"Solano County","Solano County, California","050","00","4","9","06095","06","095",340421,296191,44230,21887,22343
"Sonoma County","Sonoma County, California","050","00","4","9","06097","06","097",388222,352802,35420,14132,21288
"Stanislaus County","Stanislaus County, California","050","00","4","9","06099","06","099",370522,317678,52844,14116,38728
"Sutter County","Sutter County, California","050","00","4","9","06101","06","101",64415,55346,9069,2422,6647
"Tehama County","Tehama County, California","050","00","4","9","06103","06","103",49625,46813,2812,989,1823
"Trinity County","Trinity County, California","050","00","4","9","06105","06","105",13063,12783,280,195,85
"Tulare County","Tulare County, California","050","00","4","9","06107","06","107",311921,256996,54925,13329,41596
"Tuolumne County","Tuolumne County, California","050","00","4","9","06109","06","109",48456,46505,1951,870,1081
"Ventura County","Ventura County, California","050","00","4","9","06111","06","111",669016,555012,114004,36184,77820
"Yolo County","Yolo County, California","050","00","4","9","06113","06","113",141092,120763,20329,6104,14225
"Yuba County","Yuba County, California","050","00","4","9","06115","06","115",58228,52862,5366,1418,3948
"Adams County","Adams County, Colorado","050","00","4","8","08001","08","001",265038,254013,11025,4697,6328
"Alamosa County","Alamosa County, Colorado","050","00","4","8","08003","08","003",13617,13122,495,207,288
"Arapahoe County","Arapahoe County, Colorado","050","00","4","8","08005","08","005",391511,372373,19138,9543,9595
"Archuleta County","Archuleta County, Colorado","050","00","4","8","08007","08","007",5345,5226,119,74,45
"Baca County","Baca County, Colorado","050","00","4","8","08009","08","009",4556,4477,79,31,48
"Bent County","Bent County, Colorado","050","00","4","8","08011","08","011",5048,4959,89,58,31
"Boulder County","Boulder County, Colorado","050","00","4","8","08013","08","013",225339,212778,12561,4987,7574
"Chaffee County","Chaffee County, Colorado","050","00","4","8","08015","08","015",12684,12460,224,125,99
"Cheyenne County","Cheyenne County, Colorado","050","00","4","8","08017","08","017",2397,2353,44,15,29
"Clear Creek County","Clear Creek County, Colorado","050","00","4","8","08019","08","019",7619,7451,168,125,43
"Conejos County","Conejos County, Colorado","050","00","4","8","08021","08","021",7453,7239,214,79,135
"Costilla County","Costilla County, Colorado","050","00","4","8","08023","08","023",3190,3054,136,79,57
"Crowley County","Crowley County, Colorado","050","00","4","8","08025","08","025",3946,3811,135,50,85
"Custer County","Custer County, Colorado","050","00","4","8","08027","08","027",1926,1898,28,18,10
"Delta County","Delta County, Colorado","050","00","4","8","08029","08","029",20980,20490,490,209,281
"Denver County","Denver County, Colorado","050","00","4","8","08031","08","031",467610,432895,34715,14096,20619
"Dolores County","Dolores County, Colorado","050","00","4","8","08033","08","033",1504,1500,4,0,4
"Douglas County","Douglas County, Colorado","050","00","4","8","08035","08","035",60391,58739,1652,906,746
"Eagle County","Eagle County, Colorado","050","00","4","8","08037","08","037",21928,20378,1550,446,1104
"Elbert County","Elbert County, Colorado","050","00","4","8","08039","08","039",9646,9544,102,62,40
"El Paso County","El Paso County, Colorado","050","00","4","8","08041","08","041",397014,378629,18385,11192,7193
"Fremont County","Fremont County, Colorado","050","00","4","8","08043","08","043",32273,31739,534,295,239
"Garfield County","Garfield County, Colorado","050","00","4","8","08045","08","045",29974,29291,683,301,382
"Gilpin County","Gilpin County, Colorado","050","00","4","8","08047","08","047",3070,2994,76,31,45
"Grand County","Grand County, Colorado","050","00","4","8","08049","08","049",7966,7798,168,96,72
"Gunnison County","Gunnison County, Colorado","050","00","4","8","08051","08","051",10273,10080,193,79,114
"Hinsdale County","Hinsdale County, Colorado","050","00","4","8","08053","08","053",467,459,8,8,0
"Huerfano County","Huerfano County, Colorado","050","00","4","8","08055","08","055",6009,5846,163,128,35
"Jackson County","Jackson County, Colorado","050","00","4","8","08057","08","057",1605,1581,24,5,19
"Jefferson County","Jefferson County, Colorado","050","00","4","8","08059","08","059",438430,423626,14804,8082,6722
"Kiowa County","Kiowa County, Colorado","050","00","4","8","08061","08","061",1688,1686,2,0,2
"Kit Carson County","Kit Carson County, Colorado","050","00","4","8","08063","08","063",7140,7027,113,47,66
"Lake County","Lake County, Colorado","050","00","4","8","08065","08","065",6007,5904,103,48,55
"La Plata County","La Plata County, Colorado","050","00","4","8","08067","08","067",32284,31840,444,224,220
"Larimer County","Larimer County, Colorado","050","00","4","8","08069","08","069",186136,180399,5737,2347,3390
"Las Animas County","Las Animas County, Colorado","050","00","4","8","08071","08","071",13765,13538,227,123,104
"Lincoln County","Lincoln County, Colorado","050","00","4","8","08073","08","073",4529,4517,12,7,5
"Logan County","Logan County, Colorado","050","00","4","8","08075","08","075",17567,17152,415,222,193
"Mesa County","Mesa County, Colorado","050","00","4","8","08077","08","077",93145,91075,2070,1120,950
"Mineral County","Mineral County, Colorado","050","00","4","8","08079","08","079",558,542,16,7,9
"Moffat County","Moffat County, Colorado","050","00","4","8","08081","08","081",11357,11126,231,156,75
"Montezuma County","Montezuma County, Colorado","050","00","4","8","08083","08","083",18672,18411,261,135,126
"Montrose County","Montrose County, Colorado","050","00","4","8","08085","08","085",24423,23764,659,314,345
"Morgan County","Morgan County, Colorado","050","00","4","8","08087","08","087",21939,20687,1252,435,817
"Otero County","Otero County, Colorado","050","00","4","8","08089","08","089",20185,19666,519,280,239
"Ouray County","Ouray County, Colorado","050","00","4","8","08091","08","091",2295,2228,67,22,45
"Park County","Park County, Colorado","050","00","4","8","08093","08","093",7174,7085,89,56,33
"Phillips County","Phillips County, Colorado","050","00","4","8","08095","08","095",4189,4082,107,44,63
"Pitkin County","Pitkin County, Colorado","050","00","4","8","08097","08","097",12661,11669,992,406,586
"Prowers County","Prowers County, Colorado","050","00","4","8","08099","08","099",13347,12818,529,190,339
"Pueblo County","Pueblo County, Colorado","050","00","4","8","08101","08","101",123051,120347,2704,1510,1194
"Rio Blanco County","Rio Blanco County, Colorado","050","00","4","8","08103","08","103",5972,5824,148,17,131
"Rio Grande County","Rio Grande County, Colorado","050","00","4","8","08105","08","105",10770,10457,313,164,149
"Routt County","Routt County, Colorado","050","00","4","8","08107","08","107",14088,13852,236,128,108
"Saguache County","Saguache County, Colorado","050","00","4","8","08109","08","109",4619,4220,399,153,246
"San Juan County","San Juan County, Colorado","050","00","4","8","08111","08","111",745,731,14,5,9
"San Miguel County","San Miguel County, Colorado","050","00","4","8","08113","08","113",3653,3580,73,17,56
"Sedgwick County","Sedgwick County, Colorado","050","00","4","8","08115","08","115",2690,2642,48,37,11
"Summit County","Summit County, Colorado","050","00","4","8","08117","08","117",12881,12548,333,150,183
"Teller County","Teller County, Colorado","050","00","4","8","08119","08","119",12468,12175,293,136,157
"Washington County","Washington County, Colorado","050","00","4","8","08121","08","121",4812,4747,65,45,20
"Weld County","Weld County, Colorado","050","00","4","8","08123","08","123",131821,125944,5877,2683,3194
"Yuma County","Yuma County, Colorado","050","00","4","8","08125","08","125",8954,8874,80,25,55
"Fairfield County","Fairfield County, Connecticut","050","00","1","1","09001","09","001",827645,726684,100961,46320,54641
"Hartford County","Hartford County, Connecticut","050","00","1","1","09003","09","003",851783,766436,85347,45426,39921
"Litchfield County","Litchfield County, Connecticut","050","00","1","1","09005","09","005",174092,164671,9421,5753,3668
"Middlesex County","Middlesex County, Connecticut","050","00","1","1","09007","09","007",143196,136268,6928,4053,2875
"New Haven County","New Haven County, Connecticut","050","00","1","1","09009","09","009",804219,749414,54805,30777,24028
"New London County","New London County, Connecticut","050","00","1","1","09011","09","011",254957,244323,10634,6850,3784
"Tolland County","Tolland County, Connecticut","050","00","1","1","09013","09","013",128699,121960,6739,3261,3478
"Windham County","Windham County, Connecticut","050","00","1","1","09015","09","015",102525,97977,4548,2708,1840
"Kent County","Kent County, Delaware","050","00","3","5","10001","10","001",110993,108061,2932,1854,1078
"New Castle County","New Castle County, Delaware","050","00","3","5","10003","10","003",441946,424666,17280,9375,7905
"Sussex County","Sussex County, Delaware","050","00","3","5","10005","10","005",113229,111166,2063,1208,855
"District of Columbia","District of Columbia, District of Columbia","050","00","3","5","11001","11","001",606900,548013,58887,17228,41659
"Alachua County","Alachua County, Florida","050","00","3","5","12001","12","001",181596,170917,10679,3743,6936
"Baker County","Baker County, Florida","050","00","3","5","12003","12","003",18486,18345,141,80,61
"Bay County","Bay County, Florida","050","00","3","5","12005","12","005",126994,122672,4322,2376,1946
"Bradford County","Bradford County, Florida","050","00","3","5","12007","12","007",22515,22290,225,113,112
"Brevard County","Brevard County, Florida","050","00","3","5","12009","12","009",398978,378016,20962,11803,9159
"Broward County","Broward County, Florida","050","00","3","5","12011","12","011",1255488,1057214,198274,89949,108325
"Calhoun County","Calhoun County, Florida","050","00","3","5","12013","12","013",11011,10919,92,43,49
"Charlotte County","Charlotte County, Florida","050","00","3","5","12015","12","015",110975,103957,7018,4751,2267
"Citrus County","Citrus County, Florida","050","00","3","5","12017","12","017",93515,88935,4580,3370,1210
"Clay County","Clay County, Florida","050","00","3","5","12019","12","019",105986,102670,3316,1896,1420
"Collier County","Collier County, Florida","050","00","3","5","12021","12","021",152099,136196,15903,6294,9609
"Columbia County","Columbia County, Florida","050","00","3","5","12023","12","023",42613,41908,705,382,323
"Dade County","Dade County, Florida","050","00","3","5","12025","12","025",1937094,1062525,874569,315777,558792
"DeSoto County","DeSoto County, Florida","050","00","3","5","12027","12","027",23865,22548,1317,668,649
"Dixie County","Dixie County, Florida","050","00","3","5","12029","12","029",10585,10497,88,59,29
"Duval County","Duval County, Florida","050","00","3","5","12031","12","031",672971,649661,23310,12742,10568
"Escambia County","Escambia County, Florida","050","00","3","5","12033","12","033",262798,255772,7026,3875,3151
"Flagler County","Flagler County, Florida","050","00","3","5","12035","12","035",28701,26326,2375,1577,798
"Franklin County","Franklin County, Florida","050","00","3","5","12037","12","037",8967,8806,161,124,37
"Gadsden County","Gadsden County, Florida","050","00","3","5","12039","12","039",41105,40604,501,209,292
"Gilchrist County","Gilchrist County, Florida","050","00","3","5","12041","12","041",9667,9544,123,64,59
"Glades County","Glades County, Florida","050","00","3","5","12043","12","043",7591,7246,345,138,207
"Gulf County","Gulf County, Florida","050","00","3","5","12045","12","045",11504,11358,146,98,48
"Hamilton County","Hamilton County, Florida","050","00","3","5","12047","12","047",10930,10750,180,96,84
"Hardee County","Hardee County, Florida","050","00","3","5","12049","12","049",19499,18272,1227,694,533
"Hendry County","Hendry County, Florida","050","00","3","5","12051","12","051",25773,22002,3771,901,2870
"Hernando County","Hernando County, Florida","050","00","3","5","12053","12","053",101115,95535,5580,3829,1751
"Highlands County","Highlands County, Florida","050","00","3","5","12055","12","055",68432,65298,3134,1711,1423
"Hillsborough County","Hillsborough County, Florida","050","00","3","5","12057","12","057",834054,770701,63353,28274,35079
"Holmes County","Holmes County, Florida","050","00","3","5","12059","12","059",15778,15552,226,133,93
"Indian River County","Indian River County, Florida","050","00","3","5","12061","12","061",90208,84686,5522,3006,2516
"Jackson County","Jackson County, Florida","050","00","3","5","12063","12","063",41375,40451,924,352,572
"Jefferson County","Jefferson County, Florida","050","00","3","5","12065","12","065",11296,11182,114,63,51
"Lafayette County","Lafayette County, Florida","050","00","3","5","12067","12","067",5578,5352,226,38,188
"Lake County","Lake County, Florida","050","00","3","5","12069","12","069",152104,146809,5295,3119,2176
"Lee County","Lee County, Florida","050","00","3","5","12071","12","071",335113,317663,17450,10382,7068
"Leon County","Leon County, Florida","050","00","3","5","12073","12","073",192493,185454,7039,2564,4475
"Levy County","Levy County, Florida","050","00","3","5","12075","12","075",25923,25317,606,435,171
"Liberty County","Liberty County, Florida","050","00","3","5","12077","12","077",5569,5514,55,18,37
"Madison County","Madison County, Florida","050","00","3","5","12079","12","079",16569,16476,93,34,59
"Manatee County","Manatee County, Florida","050","00","3","5","12081","12","081",211707,200328,11379,6292,5087
"Marion County","Marion County, Florida","050","00","3","5","12083","12","083",194833,187848,6985,4185,2800
"Martin County","Martin County, Florida","050","00","3","5","12085","12","085",100900,94025,6875,3613,3262
"Monroe County","Monroe County, Florida","050","00","3","5","12087","12","087",78024,70142,7882,3301,4581
"Nassau County","Nassau County, Florida","050","00","3","5","12089","12","089",43941,43231,710,375,335
"Okaloosa County","Okaloosa County, Florida","050","00","3","5","12091","12","091",143776,137591,6185,3867,2318
"Okeechobee County","Okeechobee County, Florida","050","00","3","5","12093","12","093",29627,27753,1874,473,1401
"Orange County","Orange County, Florida","050","00","3","5","12095","12","095",677491,626436,51055,22480,28575
"Osceola County","Osceola County, Florida","050","00","3","5","12097","12","097",107728,100071,7657,3554,4103
"Palm Beach County","Palm Beach County, Florida","050","00","3","5","12099","12","099",863518,758215,105303,51203,54100
"Pasco County","Pasco County, Florida","050","00","3","5","12101","12","101",281131,264473,16658,11533,5125
"Pinellas County","Pinellas County, Florida","050","00","3","5","12103","12","103",851659,791247,60412,36273,24139
"Polk County","Polk County, Florida","050","00","3","5","12105","12","105",405382,390976,14406,7475,6931
"Putnam County","Putnam County, Florida","050","00","3","5","12107","12","107",65070,63655,1415,769,646
"St. Johns County","St. Johns County, Florida","050","00","3","5","12109","12","109",83829,80771,3058,1874,1184
"St. Lucie County","St. Lucie County, Florida","050","00","3","5","12111","12","111",150171,140653,9518,5187,4331
"Santa Rosa County","Santa Rosa County, Florida","050","00","3","5","12113","12","113",81608,79840,1768,1122,646
"Sarasota County","Sarasota County, Florida","050","00","3","5","12115","12","115",277776,261121,16655,11947,4708
"Seminole County","Seminole County, Florida","050","00","3","5","12117","12","117",287529,269494,18035,8779,9256
"Sumter County","Sumter County, Florida","050","00","3","5","12119","12","119",31577,30965,612,336,276
"Suwannee County","Suwannee County, Florida","050","00","3","5","12121","12","121",26780,26367,413,200,213
"Taylor County","Taylor County, Florida","050","00","3","5","12123","12","123",17111,16952,159,89,70
"Union County","Union County, Florida","050","00","3","5","12125","12","125",10252,10004,248,146,102
"Volusia County","Volusia County, Florida","050","00","3","5","12127","12","127",370712,349372,21340,12078,9262
"Wakulla County","Wakulla County, Florida","050","00","3","5","12129","12","129",14202,14030,172,125,47
"Walton County","Walton County, Florida","050","00","3","5","12131","12","131",27760,27304,456,198,258
"Washington County","Washington County, Florida","050","00","3","5","12133","12","133",16919,16521,398,251,147
"Appling County","Appling County, Georgia","050","00","3","5","13001","13","001",15744,15644,100,39,61
"Atkinson County","Atkinson County, Georgia","050","00","3","5","13003","13","003",6213,6115,98,16,82
"Bacon County","Bacon County, Georgia","050","00","3","5","13005","13","005",9566,9540,26,26,0
"Baker County","Baker County, Georgia","050","00","3","5","13007","13","007",3615,3611,4,2,2
"Baldwin County","Baldwin County, Georgia","050","00","3","5","13009","13","009",39530,38964,566,349,217
"Banks County","Banks County, Georgia","050","00","3","5","13011","13","011",10308,10273,35,16,19
"Barrow County","Barrow County, Georgia","050","00","3","5","13013","13","013",29721,29447,274,99,175
"Bartow County","Bartow County, Georgia","050","00","3","5","13015","13","015",55911,55455,456,186,270
"Ben Hill County","Ben Hill County, Georgia","050","00","3","5","13017","13","017",16245,16191,54,24,30
"Berrien County","Berrien County, Georgia","050","00","3","5","13019","13","019",14153,13984,169,19,150
"Bibb County","Bibb County, Georgia","050","00","3","5","13021","13","021",149967,148385,1582,746,836
"Bleckley County","Bleckley County, Georgia","050","00","3","5","13023","13","023",10430,10363,67,18,49
"Brantley County","Brantley County, Georgia","050","00","3","5","13025","13","025",11077,11040,37,15,22
"Brooks County","Brooks County, Georgia","050","00","3","5","13027","13","027",15398,15127,271,101,170
"Bryan County","Bryan County, Georgia","050","00","3","5","13029","13","029",15438,15368,70,30,40
"Bulloch County","Bulloch County, Georgia","050","00","3","5","13031","13","031",43125,42624,501,215,286
"Burke County","Burke County, Georgia","050","00","3","5","13033","13","033",20579,20491,88,57,31
"Butts County","Butts County, Georgia","050","00","3","5","13035","13","035",15326,15216,110,92,18
"Calhoun County","Calhoun County, Georgia","050","00","3","5","13037","13","037",5013,5008,5,5,0
"Camden County","Camden County, Georgia","050","00","3","5","13039","13","039",30167,29523,644,305,339
"Candler County","Candler County, Georgia","050","00","3","5","13043","13","043",7744,7670,74,25,49
"Carroll County","Carroll County, Georgia","050","00","3","5","13045","13","045",71422,70815,607,277,330
"Catoosa County","Catoosa County, Georgia","050","00","3","5","13047","13","047",42464,42300,164,73,91
"Charlton County","Charlton County, Georgia","050","00","3","5","13049","13","049",8496,8460,36,14,22
"Chatham County","Chatham County, Georgia","050","00","3","5","13051","13","051",216935,212496,4439,2257,2182
"Chattahoochee County","Chattahoochee County, Georgia","050","00","3","5","13053","13","053",16934,15793,1141,465,676
"Chattooga County","Chattooga County, Georgia","050","00","3","5","13055","13","055",22242,22217,25,16,9
"Cherokee County","Cherokee County, Georgia","050","00","3","5","13057","13","057",90204,88785,1419,722,697
"Clarke County","Clarke County, Georgia","050","00","3","5","13059","13","059",87594,83678,3916,1001,2915
"Clay County","Clay County, Georgia","050","00","3","5","13061","13","061",3364,3349,15,8,7
"Clayton County","Clayton County, Georgia","050","00","3","5","13063","13","063",182052,174353,7699,2878,4821
"Clinch County","Clinch County, Georgia","050","00","3","5","13065","13","065",6160,6153,7,7,0
"Cobb County","Cobb County, Georgia","050","00","3","5","13067","13","067",447745,429284,18461,6744,11717
"Coffee County","Coffee County, Georgia","050","00","3","5","13069","13","069",29592,29152,440,138,302
"Colquitt County","Colquitt County, Georgia","050","00","3","5","13071","13","071",36645,35541,1104,79,1025
"Columbia County","Columbia County, Georgia","050","00","3","5","13073","13","073",66031,63725,2306,1569,737
"Cook County","Cook County, Georgia","050","00","3","5","13075","13","075",13456,13202,254,30,224
"Coweta County","Coweta County, Georgia","050","00","3","5","13077","13","077",53853,53423,430,209,221
"Crawford County","Crawford County, Georgia","050","00","3","5","13079","13","079",8991,8900,91,91,0
"Crisp County","Crisp County, Georgia","050","00","3","5","13081","13","081",20011,19952,59,21,38
"Dade County","Dade County, Georgia","050","00","3","5","13083","13","083",13147,13049,98,61,37
"Dawson County","Dawson County, Georgia","050","00","3","5","13085","13","085",9429,9373,56,15,41
"Decatur County","Decatur County, Georgia","050","00","3","5","13087","13","087",25511,25118,393,35,358
"DeKalb County","DeKalb County, Georgia","050","00","3","5","13089","13","089",545837,509345,36492,12704,23788
"Dodge County","Dodge County, Georgia","050","00","3","5","13091","13","091",17607,17548,59,27,32
"Dooly County","Dooly County, Georgia","050","00","3","5","13093","13","093",9901,9852,49,23,26
"Dougherty County","Dougherty County, Georgia","050","00","3","5","13095","13","095",96311,95405,906,455,451
"Douglas County","Douglas County, Georgia","050","00","3","5","13097","13","097",71120,70170,950,529,421
"Early County","Early County, Georgia","050","00","3","5","13099","13","099",11854,11826,28,0,28
"Echols County","Echols County, Georgia","050","00","3","5","13101","13","101",2334,2296,38,18,20
"Effingham County","Effingham County, Georgia","050","00","3","5","13103","13","103",25687,25509,178,64,114
"Elbert County","Elbert County, Georgia","050","00","3","5","13105","13","105",18949,18789,160,69,91
"Emanuel County","Emanuel County, Georgia","050","00","3","5","13107","13","107",20546,20461,85,18,67
"Evans County","Evans County, Georgia","050","00","3","5","13109","13","109",8724,8682,42,6,36
"Fannin County","Fannin County, Georgia","050","00","3","5","13111","13","111",15992,15900,92,79,13
"Fayette County","Fayette County, Georgia","050","00","3","5","13113","13","113",62415,60638,1777,805,972
"Floyd County","Floyd County, Georgia","050","00","3","5","13115","13","115",81251,80366,885,321,564
"Forsyth County","Forsyth County, Georgia","050","00","3","5","13117","13","117",44083,43568,515,173,342
"Franklin County","Franklin County, Georgia","050","00","3","5","13119","13","119",16650,16576,74,35,39
"Fulton County","Fulton County, Georgia","050","00","3","5","13121","13","121",648951,622174,26777,9040,17737
"Gilmer County","Gilmer County, Georgia","050","00","3","5","13123","13","123",13368,13308,60,23,37
"Glascock County","Glascock County, Georgia","050","00","3","5","13125","13","125",2357,2347,10,3,7
"Glynn County","Glynn County, Georgia","050","00","3","5","13127","13","127",62496,61640,856,484,372
"Gordon County","Gordon County, Georgia","050","00","3","5","13129","13","129",35072,34847,225,103,122
"Grady County","Grady County, Georgia","050","00","3","5","13131","13","131",20279,20130,149,74,75
"Greene County","Greene County, Georgia","050","00","3","5","13133","13","133",11793,11734,59,29,30
"Gwinnett County","Gwinnett County, Georgia","050","00","3","5","13135","13","135",352910,335107,17803,6269,11534
"Habersham County","Habersham County, Georgia","050","00","3","5","13137","13","137",27621,26814,807,237,570
"Hall County","Hall County, Georgia","050","00","3","5","13139","13","139",95428,91042,4386,738,3648
"Hancock County","Hancock County, Georgia","050","00","3","5","13141","13","141",8908,8884,24,22,2
"Haralson County","Haralson County, Georgia","050","00","3","5","13143","13","143",21966,21815,151,102,49
"Harris County","Harris County, Georgia","050","00","3","5","13145","13","145",17788,17590,198,144,54
"Hart County","Hart County, Georgia","050","00","3","5","13147","13","147",19712,19650,62,45,17
"Heard County","Heard County, Georgia","050","00","3","5","13149","13","149",8628,8598,30,28,2
"Henry County","Henry County, Georgia","050","00","3","5","13151","13","151",58741,58164,577,318,259
"Houston County","Houston County, Georgia","050","00","3","5","13153","13","153",89208,87201,2007,1130,877
"Irwin County","Irwin County, Georgia","050","00","3","5","13155","13","155",8649,8636,13,7,6
"Jackson County","Jackson County, Georgia","050","00","3","5","13157","13","157",30005,29819,186,102,84
"Jasper County","Jasper County, Georgia","050","00","3","5","13159","13","159",8453,8369,84,46,38
"Jeff Davis County","Jeff Davis County, Georgia","050","00","3","5","13161","13","161",12032,11955,77,20,57
"Jefferson County","Jefferson County, Georgia","050","00","3","5","13163","13","163",17408,17338,70,22,48
"Jenkins County","Jenkins County, Georgia","050","00","3","5","13165","13","165",8247,8230,17,9,8
"Johnson County","Johnson County, Georgia","050","00","3","5","13167","13","167",8329,8305,24,24,0
"Jones County","Jones County, Georgia","050","00","3","5","13169","13","169",20739,20632,107,80,27
"Lamar County","Lamar County, Georgia","050","00","3","5","13171","13","171",13038,12994,44,43,1
"Lanier County","Lanier County, Georgia","050","00","3","5","13173","13","173",5531,5484,47,21,26
"Laurens County","Laurens County, Georgia","050","00","3","5","13175","13","175",39988,39792,196,112,84
"Lee County","Lee County, Georgia","050","00","3","5","13177","13","177",16250,16136,114,32,82
"Liberty County","Liberty County, Georgia","050","00","3","5","13179","13","179",52745,50715,2030,984,1046
"Lincoln County","Lincoln County, Georgia","050","00","3","5","13181","13","181",7442,7423,19,12,7
"Long County","Long County, Georgia","050","00","3","5","13183","13","183",6202,6077,125,40,85
"Lowndes County","Lowndes County, Georgia","050","00","3","5","13185","13","185",75981,74822,1159,544,615
"Lumpkin County","Lumpkin County, Georgia","050","00","3","5","13187","13","187",14573,14462,111,43,68
"McDuffie County","McDuffie County, Georgia","050","00","3","5","13189","13","189",20119,20075,44,39,5
"McIntosh County","McIntosh County, Georgia","050","00","3","5","13191","13","191",8634,8611,23,23,0
"Macon County","Macon County, Georgia","050","00","3","5","13193","13","193",13114,12986,128,18,110
"Madison County","Madison County, Georgia","050","00","3","5","13195","13","195",21050,20880,170,85,85
"Marion County","Marion County, Georgia","050","00","3","5","13197","13","197",5590,5566,24,11,13
"Meriwether County","Meriwether County, Georgia","050","00","3","5","13199","13","199",22411,22341,70,48,22
"Miller County","Miller County, Georgia","050","00","3","5","13201","13","201",6280,6254,26,8,18
"Mitchell County","Mitchell County, Georgia","050","00","3","5","13205","13","205",20275,20158,117,32,85
"Monroe County","Monroe County, Georgia","050","00","3","5","13207","13","207",17113,16954,159,81,78
"Montgomery County","Montgomery County, Georgia","050","00","3","5","13209","13","209",7163,7060,103,16,87
"Morgan County","Morgan County, Georgia","050","00","3","5","13211","13","211",12883,12776,107,92,15
"Murray County","Murray County, Georgia","050","00","3","5","13213","13","213",26147,26016,131,65,66
"Muscogee County","Muscogee County, Georgia","050","00","3","5","13215","13","215",179278,173177,6101,3595,2506
"Newton County","Newton County, Georgia","050","00","3","5","13217","13","217",41808,41484,324,204,120
"Oconee County","Oconee County, Georgia","050","00","3","5","13219","13","219",17618,17445,173,73,100
"Oglethorpe County","Oglethorpe County, Georgia","050","00","3","5","13221","13","221",9763,9703,60,9,51
"Paulding County","Paulding County, Georgia","050","00","3","5","13223","13","223",41611,41335,276,121,155
"Peach County","Peach County, Georgia","050","00","3","5","13225","13","225",21189,20846,343,224,119
"Pickens County","Pickens County, Georgia","050","00","3","5","13227","13","227",14432,14403,29,16,13
"Pierce County","Pierce County, Georgia","050","00","3","5","13229","13","229",13328,13235,93,70,23
"Pike County","Pike County, Georgia","050","00","3","5","13231","13","231",10224,10140,84,70,14
"Polk County","Polk County, Georgia","050","00","3","5","13233","13","233",33815,33493,322,141,181
"Pulaski County","Pulaski County, Georgia","050","00","3","5","13235","13","235",8108,7965,143,112,31
"Putnam County","Putnam County, Georgia","050","00","3","5","13237","13","237",14137,13875,262,106,156
"Quitman County","Quitman County, Georgia","050","00","3","5","13239","13","239",2209,2188,21,21,0
"Rabun County","Rabun County, Georgia","050","00","3","5","13241","13","241",11648,11516,132,65,67
"Randolph County","Randolph County, Georgia","050","00","3","5","13243","13","243",8023,7954,69,0,69
"Richmond County","Richmond County, Georgia","050","00","3","5","13245","13","245",189719,184004,5715,3527,2188
"Rockdale County","Rockdale County, Georgia","050","00","3","5","13247","13","247",54091,53004,1087,473,614
"Schley County","Schley County, Georgia","050","00","3","5","13249","13","249",3588,3579,9,2,7
"Screven County","Screven County, Georgia","050","00","3","5","13251","13","251",13842,13758,84,32,52
"Seminole County","Seminole County, Georgia","050","00","3","5","13253","13","253",9010,8497,513,17,496
"Spalding County","Spalding County, Georgia","050","00","3","5","13255","13","255",54457,54036,421,226,195
"Stephens County","Stephens County, Georgia","050","00","3","5","13257","13","257",23257,23003,254,95,159
"Stewart County","Stewart County, Georgia","050","00","3","5","13259","13","259",5654,5645,9,3,6
"Sumter County","Sumter County, Georgia","050","00","3","5","13261","13","261",30228,30051,177,91,86
"Talbot County","Talbot County, Georgia","050","00","3","5","13263","13","263",6524,6502,22,22,0
"Taliaferro County","Taliaferro County, Georgia","050","00","3","5","13265","13","265",1915,1900,15,9,6
"Tattnall County","Tattnall County, Georgia","050","00","3","5","13267","13","267",17722,17358,364,48,316
"Taylor County","Taylor County, Georgia","050","00","3","5","13269","13","269",7642,7605,37,25,12
"Telfair County","Telfair County, Georgia","050","00","3","5","13271","13","271",11000,10996,4,4,0
"Terrell County","Terrell County, Georgia","050","00","3","5","13273","13","273",10653,10626,27,0,27
"Thomas County","Thomas County, Georgia","050","00","3","5","13275","13","275",38986,38707,279,188,91
"Tift County","Tift County, Georgia","050","00","3","5","13277","13","277",34998,34027,971,191,780
"Toombs County","Toombs County, Georgia","050","00","3","5","13279","13","279",24072,23856,216,152,64
"Towns County","Towns County, Georgia","050","00","3","5","13281","13","281",6754,6662,92,64,28
"Treutlen County","Treutlen County, Georgia","050","00","3","5","13283","13","283",5994,5986,8,8,0
"Troup County","Troup County, Georgia","050","00","3","5","13285","13","285",55536,54989,547,106,441
"Turner County","Turner County, Georgia","050","00","3","5","13287","13","287",8703,8673,30,30,0
"Twiggs County","Twiggs County, Georgia","050","00","3","5","13289","13","289",9806,9784,22,20,2
"Union County","Union County, Georgia","050","00","3","5","13291","13","291",11993,11887,106,55,51
"Upson County","Upson County, Georgia","050","00","3","5","13293","13","293",26300,26151,149,72,77
"Walker County","Walker County, Georgia","050","00","3","5","13295","13","295",58340,58098,242,133,109
"Walton County","Walton County, Georgia","050","00","3","5","13297","13","297",38586,38336,250,136,114
"Ware County","Ware County, Georgia","050","00","3","5","13299","13","299",35471,35250,221,111,110
"Warren County","Warren County, Georgia","050","00","3","5","13301","13","301",6078,6048,30,19,11
"Washington County","Washington County, Georgia","050","00","3","5","13303","13","303",19112,19073,39,23,16
"Wayne County","Wayne County, Georgia","050","00","3","5","13305","13","305",22356,22245,111,93,18
"Webster County","Webster County, Georgia","050","00","3","5","13307","13","307",2263,2261,2,2,0
"Wheeler County","Wheeler County, Georgia","050","00","3","5","13309","13","309",4903,4886,17,11,6
"White County","White County, Georgia","050","00","3","5","13311","13","311",13006,12853,153,100,53
"Whitfield County","Whitfield County, Georgia","050","00","3","5","13313","13","313",72462,70616,1846,514,1332
"Wilcox County","Wilcox County, Georgia","050","00","3","5","13315","13","315",7008,7002,6,6,0
"Wilkes County","Wilkes County, Georgia","050","00","3","5","13317","13","317",10597,10552,45,23,22
"Wilkinson County","Wilkinson County, Georgia","050","00","3","5","13319","13","319",10228,10198,30,20,10
"Worth County","Worth County, Georgia","050","00","3","5","13321","13","321",19745,19628,117,43,74
"Hawaii County","Hawaii County, Hawaii","050","00","4","9","15001","15","001",120317,110046,10271,5473,4798
"Honolulu County","Honolulu County, Hawaii","050","00","4","9","15003","15","003",836231,705269,130962,72189,58773
"Kalawao County","Kalawao County, Hawaii","050","00","4","9","15005","15","005",130,110,20,20,0
"Kauai County","Kauai County, Hawaii","050","00","4","9","15007","15","007",51177,43723,7454,4312,3142
"Maui County","Maui County, Hawaii","050","00","4","9","15009","15","009",100374,86377,13997,7989,6008
"Ada County","Ada County, Idaho","050","00","4","8","16001","16","001",205775,201386,4389,2407,1982
"Adams County","Adams County, Idaho","050","00","4","8","16003","16","003",3254,3235,19,15,4
"Bannock County","Bannock County, Idaho","050","00","4","8","16005","16","005",66026,64959,1067,566,501
"Bear Lake County","Bear Lake County, Idaho","050","00","4","8","16007","16","007",6084,6004,80,50,30
"Benewah County","Benewah County, Idaho","050","00","4","8","16009","16","009",7937,7856,81,48,33
"Bingham County","Bingham County, Idaho","050","00","4","8","16011","16","011",37583,36209,1374,475,899
"Blaine County","Blaine County, Idaho","050","00","4","8","16013","16","013",13552,13126,426,209,217
"Boise County","Boise County, Idaho","050","00","4","8","16015","16","015",3509,3444,65,58,7
"Bonner County","Bonner County, Idaho","050","00","4","8","16017","16","017",26622,26110,512,305,207
"Bonneville County","Bonneville County, Idaho","050","00","4","8","16019","16","019",72207,70395,1812,899,913
"Boundary County","Boundary County, Idaho","050","00","4","8","16021","16","021",8332,8024,308,76,232
"Butte County","Butte County, Idaho","050","00","4","8","16023","16","023",2918,2862,56,10,46
"Camas County","Camas County, Idaho","050","00","4","8","16025","16","025",727,711,16,4,12
"Canyon County","Canyon County, Idaho","050","00","4","8","16027","16","027",90076,86099,3977,1523,2454
"Caribou County","Caribou County, Idaho","050","00","4","8","16029","16","029",6963,6814,149,46,103
"Cassia County","Cassia County, Idaho","050","00","4","8","16031","16","031",19532,18690,842,171,671
"Clark County","Clark County, Idaho","050","00","4","8","16033","16","033",762,705,57,25,32
"Clearwater County","Clearwater County, Idaho","050","00","4","8","16035","16","035",8505,8420,85,50,35
"Custer County","Custer County, Idaho","050","00","4","8","16037","16","037",4133,4084,49,30,19
"Elmore County","Elmore County, Idaho","050","00","4","8","16039","16","039",21205,19958,1247,454,793
"Franklin County","Franklin County, Idaho","050","00","4","8","16041","16","041",9232,9140,92,35,57
"Fremont County","Fremont County, Idaho","050","00","4","8","16043","16","043",10937,10471,466,129,337
"Gem County","Gem County, Idaho","050","00","4","8","16045","16","045",11844,11450,394,161,233
"Gooding County","Gooding County, Idaho","050","00","4","8","16047","16","047",11633,11027,606,195,411
"Idaho County","Idaho County, Idaho","050","00","4","8","16049","16","049",13783,13660,123,83,40
"Jefferson County","Jefferson County, Idaho","050","00","4","8","16051","16","051",16543,15930,613,202,411
"Jerome County","Jerome County, Idaho","050","00","4","8","16053","16","053",15138,14676,462,128,334
"Kootenai County","Kootenai County, Idaho","050","00","4","8","16055","16","055",69795,68479,1316,827,489
"Latah County","Latah County, Idaho","050","00","4","8","16057","16","057",30617,29409,1208,286,922
"Lemhi County","Lemhi County, Idaho","050","00","4","8","16059","16","059",6899,6762,137,52,85
"Lewis County","Lewis County, Idaho","050","00","4","8","16061","16","061",3516,3491,25,21,4
"Lincoln County","Lincoln County, Idaho","050","00","4","8","16063","16","063",3308,3267,41,26,15
"Madison County","Madison County, Idaho","050","00","4","8","16065","16","065",23674,22687,987,172,815
"Minidoka County","Minidoka County, Idaho","050","00","4","8","16067","16","067",19361,18219,1142,490,652
"Nez Perce County","Nez Perce County, Idaho","050","00","4","8","16069","16","069",33754,33288,466,251,215
"Oneida County","Oneida County, Idaho","050","00","4","8","16071","16","071",3492,3466,26,13,13
"Owyhee County","Owyhee County, Idaho","050","00","4","8","16073","16","073",8392,7626,766,143,623
"Payette County","Payette County, Idaho","050","00","4","8","16075","16","075",16434,15965,469,119,350
"Power County","Power County, Idaho","050","00","4","8","16077","16","077",7086,6742,344,103,241
"Shoshone County","Shoshone County, Idaho","050","00","4","8","16079","16","079",13931,13682,249,163,86
"Teton County","Teton County, Idaho","050","00","4","8","16081","16","081",3439,3241,198,48,150
"Twin Falls County","Twin Falls County, Idaho","050","00","4","8","16083","16","083",53580,51959,1621,600,1021
"Valley County","Valley County, Idaho","050","00","4","8","16085","16","085",6109,5997,112,59,53
"Washington County","Washington County, Idaho","050","00","4","8","16087","16","087",8550,8119,431,129,302
"Adams County","Adams County, Illinois","050","00","2","3","17001","17","001",66090,65655,435,217,218
"Alexander County","Alexander County, Illinois","050","00","2","3","17003","17","003",10626,10577,49,12,37
"Bond County","Bond County, Illinois","050","00","2","3","17005","17","005",14991,14890,101,44,57
"Boone County","Boone County, Illinois","050","00","2","3","17007","17","007",30806,29557,1249,495,754
"Brown County","Brown County, Illinois","050","00","2","3","17009","17","009",5836,5761,75,38,37
"Bureau County","Bureau County, Illinois","050","00","2","3","17011","17","011",35688,35085,603,257,346
"Calhoun County","Calhoun County, Illinois","050","00","2","3","17013","17","013",5322,5309,13,13,0
"Carroll County","Carroll County, Illinois","050","00","2","3","17015","17","015",16805,16562,243,167,76
"Cass County","Cass County, Illinois","050","00","2","3","17017","17","017",13437,13351,86,60,26
"Champaign County","Champaign County, Illinois","050","00","2","3","17019","17","019",173025,162471,10554,3634,6920
"Christian County","Christian County, Illinois","050","00","2","3","17021","17","021",34418,34202,216,147,69
"Clark County","Clark County, Illinois","050","00","2","3","17023","17","023",15921,15822,99,57,42
"Clay County","Clay County, Illinois","050","00","2","3","17025","17","025",14460,14399,61,24,37
"Clinton County","Clinton County, Illinois","050","00","2","3","17027","17","027",33944,33754,190,148,42
"Coles County","Coles County, Illinois","050","00","2","3","17029","17","029",51644,51054,590,273,317
"Cook County","Cook County, Illinois","050","00","2","3","17031","17","031",5105067,4387750,717317,307955,409362
"Crawford County","Crawford County, Illinois","050","00","2","3","17033","17","033",19464,19378,86,45,41
"Cumberland County","Cumberland County, Illinois","050","00","2","3","17035","17","035",10670,10635,35,15,20
"DeKalb County","DeKalb County, Illinois","050","00","2","3","17037","17","037",77932,74552,3380,1267,2113
"De Witt County","De Witt County, Illinois","050","00","2","3","17039","17","039",16516,16455,61,27,34
"Douglas County","Douglas County, Illinois","050","00","2","3","17041","17","041",19464,19279,185,49,136
"DuPage County","DuPage County, Illinois","050","00","2","3","17043","17","043",781666,710331,71335,37151,34184
"Edgar County","Edgar County, Illinois","050","00","2","3","17045","17","045",19595,19477,118,81,37
"Edwards County","Edwards County, Illinois","050","00","2","3","17047","17","047",7440,7413,27,14,13
"Effingham County","Effingham County, Illinois","050","00","2","3","17049","17","049",31704,31558,146,89,57
"Fayette County","Fayette County, Illinois","050","00","2","3","17051","17","051",20893,20818,75,52,23
"Ford County","Ford County, Illinois","050","00","2","3","17053","17","053",14275,14136,139,98,41
"Franklin County","Franklin County, Illinois","050","00","2","3","17055","17","055",40319,40062,257,206,51
"Fulton County","Fulton County, Illinois","050","00","2","3","17057","17","057",38080,37721,359,242,117
"Gallatin County","Gallatin County, Illinois","050","00","2","3","17059","17","059",6909,6903,6,4,2
"Greene County","Greene County, Illinois","050","00","2","3","17061","17","061",15317,15273,44,26,18
"Grundy County","Grundy County, Illinois","050","00","2","3","17063","17","063",32337,31794,543,275,268
"Hamilton County","Hamilton County, Illinois","050","00","2","3","17065","17","065",8499,8468,31,18,13
"Hancock County","Hancock County, Illinois","050","00","2","3","17067","17","067",21373,21230,143,85,58
"Hardin County","Hardin County, Illinois","050","00","2","3","17069","17","069",5189,5157,32,32,0
"Henderson County","Henderson County, Illinois","050","00","2","3","17071","17","071",8096,8071,25,25,0
"Henry County","Henry County, Illinois","050","00","2","3","17073","17","073",51159,50672,487,389,98
"Iroquois County","Iroquois County, Illinois","050","00","2","3","17075","17","075",30787,30446,341,155,186
"Jackson County","Jackson County, Illinois","050","00","2","3","17077","17","077",61067,57988,3079,460,2619
"Jasper County","Jasper County, Illinois","050","00","2","3","17079","17","079",10609,10574,35,17,18
"Jefferson County","Jefferson County, Illinois","050","00","2","3","17081","17","081",37020,36786,234,150,84
"Jersey County","Jersey County, Illinois","050","00","2","3","17083","17","083",20539,20419,120,40,80
"Jo Daviess County","Jo Daviess County, Illinois","050","00","2","3","17085","17","085",21821,21660,161,126,35
"Johnson County","Johnson County, Illinois","050","00","2","3","17087","17","087",11347,11250,97,43,54
"Kane County","Kane County, Illinois","050","00","2","3","17089","17","089",317471,291371,26100,9749,16351
"Kankakee County","Kankakee County, Illinois","050","00","2","3","17091","17","091",96255,94723,1532,881,651
"Kendall County","Kendall County, Illinois","050","00","2","3","17093","17","093",39413,38118,1295,575,720
"Knox County","Knox County, Illinois","050","00","2","3","17095","17","095",56393,55613,780,432,348
"Lake County","Lake County, Illinois","050","00","2","3","17097","17","097",516418,474835,41583,19740,21843
"La Salle County","La Salle County, Illinois","050","00","2","3","17099","17","099",106913,104906,2007,1355,652
"Lawrence County","Lawrence County, Illinois","050","00","2","3","17101","17","101",15972,15927,45,33,12
"Lee County","Lee County, Illinois","050","00","2","3","17103","17","103",34392,34057,335,185,150
"Livingston County","Livingston County, Illinois","050","00","2","3","17105","17","105",39301,38817,484,291,193
"Logan County","Logan County, Illinois","050","00","2","3","17107","17","107",30798,30440,358,144,214
"McDonough County","McDonough County, Illinois","050","00","2","3","17109","17","109",35244,34134,1110,341,769
"McHenry County","McHenry County, Illinois","050","00","2","3","17111","17","111",183241,175365,7876,4433,3443
"McLean County","McLean County, Illinois","050","00","2","3","17113","17","113",129180,126700,2480,1046,1434
"Macon County","Macon County, Illinois","050","00","2","3","17115","17","115",117206,116241,965,572,393
"Macoupin County","Macoupin County, Illinois","050","00","2","3","17117","17","117",47679,47201,478,374,104
"Madison County","Madison County, Illinois","050","00","2","3","17119","17","119",249238,246312,2926,1743,1183
"Marion County","Marion County, Illinois","050","00","2","3","17121","17","121",41561,41070,491,335,156
"Marshall County","Marshall County, Illinois","050","00","2","3","17123","17","123",12846,12693,153,108,45
"Mason County","Mason County, Illinois","050","00","2","3","17125","17","125",16269,16163,106,84,22
"Massac County","Massac County, Illinois","050","00","2","3","17127","17","127",14752,14675,77,55,22
"Menard County","Menard County, Illinois","050","00","2","3","17129","17","129",11164,11118,46,42,4
"Mercer County","Mercer County, Illinois","050","00","2","3","17131","17","131",17290,17248,42,38,4
"Monroe County","Monroe County, Illinois","050","00","2","3","17133","17","133",22422,22267,155,128,27
"Montgomery County","Montgomery County, Illinois","050","00","2","3","17135","17","135",30728,30482,246,168,78
"Morgan County","Morgan County, Illinois","050","00","2","3","17137","17","137",36397,36067,330,240,90
"Moultrie County","Moultrie County, Illinois","050","00","2","3","17139","17","139",13930,13808,122,82,40
"Ogle County","Ogle County, Illinois","050","00","2","3","17141","17","141",45957,45064,893,493,400
"Peoria County","Peoria County, Illinois","050","00","2","3","17143","17","143",182827,178599,4228,2204,2024
"Perry County","Perry County, Illinois","050","00","2","3","17145","17","145",21412,21288,124,70,54
"Piatt County","Piatt County, Illinois","050","00","2","3","17147","17","147",15548,15514,34,6,28
"Pike County","Pike County, Illinois","050","00","2","3","17149","17","149",17577,17544,33,20,13
"Pope County","Pope County, Illinois","050","00","2","3","17151","17","151",4373,4344,29,18,11
"Pulaski County","Pulaski County, Illinois","050","00","2","3","17153","17","153",7523,7515,8,2,6
"Putnam County","Putnam County, Illinois","050","00","2","3","17155","17","155",5730,5595,135,80,55
"Randolph County","Randolph County, Illinois","050","00","2","3","17157","17","157",34583,34411,172,102,70
"Richland County","Richland County, Illinois","050","00","2","3","17159","17","159",16545,16470,75,49,26
"Rock Island County","Rock Island County, Illinois","050","00","2","3","17161","17","161",148723,144703,4020,2261,1759
"St. Clair County","St. Clair County, Illinois","050","00","2","3","17163","17","163",262852,259605,3247,1898,1349
"Saline County","Saline County, Illinois","050","00","2","3","17165","17","165",26551,26438,113,85,28
"Sangamon County","Sangamon County, Illinois","050","00","2","3","17167","17","167",178386,175642,2744,1815,929
"Schuyler County","Schuyler County, Illinois","050","00","2","3","17169","17","169",7498,7487,11,0,11
"Scott County","Scott County, Illinois","050","00","2","3","17171","17","171",5644,5633,11,11,0
"Shelby County","Shelby County, Illinois","050","00","2","3","17173","17","173",22261,22203,58,31,27
"Stark County","Stark County, Illinois","050","00","2","3","17175","17","175",6534,6500,34,29,5
"Stephenson County","Stephenson County, Illinois","050","00","2","3","17177","17","177",48052,47280,772,549,223
"Tazewell County","Tazewell County, Illinois","050","00","2","3","17179","17","179",123692,122366,1326,895,431
"Union County","Union County, Illinois","050","00","2","3","17181","17","181",17619,17514,105,85,20
"Vermilion County","Vermilion County, Illinois","050","00","2","3","17183","17","183",88257,87308,949,544,405
"Wabash County","Wabash County, Illinois","050","00","2","3","17185","17","185",13111,12951,160,47,113
"Warren County","Warren County, Illinois","050","00","2","3","17187","17","187",19181,19002,179,113,66
"Washington County","Washington County, Illinois","050","00","2","3","17189","17","189",14965,14901,64,21,43
"Wayne County","Wayne County, Illinois","050","00","2","3","17191","17","191",17241,17117,124,68,56
"White County","White County, Illinois","050","00","2","3","17193","17","193",16522,16446,76,32,44
"Whiteside County","Whiteside County, Illinois","050","00","2","3","17195","17","195",60186,59091,1095,517,578
"Will County","Will County, Illinois","050","00","2","3","17197","17","197",357313,341661,15652,8192,7460
"Williamson County","Williamson County, Illinois","050","00","2","3","17199","17","199",57733,57110,623,316,307
"Winnebago County","Winnebago County, Illinois","050","00","2","3","17201","17","201",252913,243561,9352,5045,4307
"Woodford County","Woodford County, Illinois","050","00","2","3","17203","17","203",32653,32411,242,171,71
"Adams County","Adams County, Indiana","050","00","2","3","18001","18","001",31095,30873,222,128,94
"Allen County","Allen County, Indiana","050","00","2","3","18003","18","003",300836,294954,5882,3317,2565
"Bartholomew County","Bartholomew County, Indiana","050","00","2","3","18005","18","005",63657,62670,987,320,667
"Benton County","Benton County, Indiana","050","00","2","3","18007","18","007",9441,9397,44,29,15
"Blackford County","Blackford County, Indiana","050","00","2","3","18009","18","009",14067,14026,41,9,32
"Boone County","Boone County, Indiana","050","00","2","3","18011","18","011",38147,37837,310,132,178
"Brown County","Brown County, Indiana","050","00","2","3","18013","18","013",14080,13982,98,68,30
"Carroll County","Carroll County, Indiana","050","00","2","3","18015","18","015",18809,18697,112,73,39
"Cass County","Cass County, Indiana","050","00","2","3","18017","18","017",38413,38167,246,180,66
"Clark County","Clark County, Indiana","050","00","2","3","18019","18","019",87777,87035,742,469,273
"Clay County","Clay County, Indiana","050","00","2","3","18021","18","021",24705,24578,127,117,10
"Clinton County","Clinton County, Indiana","050","00","2","3","18023","18","023",30974,30832,142,84,58
"Crawford County","Crawford County, Indiana","050","00","2","3","18025","18","025",9914,9897,17,15,2
"Daviess County","Daviess County, Indiana","050","00","2","3","18027","18","027",27533,27467,66,33,33
"Dearborn County","Dearborn County, Indiana","050","00","2","3","18029","18","029",38835,38595,240,128,112
"Decatur County","Decatur County, Indiana","050","00","2","3","18031","18","031",23645,23433,212,99,113
"De Kalb County","De Kalb County, Indiana","050","00","2","3","18033","18","033",35324,35063,261,145,116
"Delaware County","Delaware County, Indiana","050","00","2","3","18035","18","035",119659,118304,1355,544,811
"Dubois County","Dubois County, Indiana","050","00","2","3","18037","18","037",36616,36409,207,79,128
"Elkhart County","Elkhart County, Indiana","050","00","2","3","18039","18","039",156198,152884,3314,1205,2109
"Fayette County","Fayette County, Indiana","050","00","2","3","18041","18","041",26015,25863,152,122,30
"Floyd County","Floyd County, Indiana","050","00","2","3","18043","18","043",64404,63808,596,307,289
"Fountain County","Fountain County, Indiana","050","00","2","3","18045","18","045",17808,17741,67,62,5
"Franklin County","Franklin County, Indiana","050","00","2","3","18047","18","047",19580,19510,70,50,20
"Fulton County","Fulton County, Indiana","050","00","2","3","18049","18","049",18840,18771,69,32,37
"Gibson County","Gibson County, Indiana","050","00","2","3","18051","18","051",31913,31825,88,29,59
"Grant County","Grant County, Indiana","050","00","2","3","18053","18","053",74169,73590,579,396,183
"Greene County","Greene County, Indiana","050","00","2","3","18055","18","055",30410,30297,113,75,38
"Hamilton County","Hamilton County, Indiana","050","00","2","3","18057","18","057",108936,106573,2363,1209,1154
"Hancock County","Hancock County, Indiana","050","00","2","3","18059","18","059",45527,45026,501,298,203
"Harrison County","Harrison County, Indiana","050","00","2","3","18061","18","061",29890,29689,201,147,54
"Hendricks County","Hendricks County, Indiana","050","00","2","3","18063","18","063",75717,75256,461,297,164
"Henry County","Henry County, Indiana","050","00","2","3","18065","18","065",48139,47970,169,113,56
"Howard County","Howard County, Indiana","050","00","2","3","18067","18","067",80827,79856,971,666,305
"Huntington County","Huntington County, Indiana","050","00","2","3","18069","18","069",35427,35139,288,118,170
"Jackson County","Jackson County, Indiana","050","00","2","3","18071","18","071",37730,37445,285,135,150
"Jasper County","Jasper County, Indiana","050","00","2","3","18073","18","073",24960,24710,250,171,79
"Jay County","Jay County, Indiana","050","00","2","3","18075","18","075",21512,21434,78,51,27
"Jefferson County","Jefferson County, Indiana","050","00","2","3","18077","18","077",29797,29500,297,112,185
"Jennings County","Jennings County, Indiana","050","00","2","3","18079","18","079",23661,23580,81,58,23
"Johnson County","Johnson County, Indiana","050","00","2","3","18081","18","081",88109,86981,1128,554,574
"Knox County","Knox County, Indiana","050","00","2","3","18083","18","083",39884,39598,286,146,140
"Kosciusko County","Kosciusko County, Indiana","050","00","2","3","18085","18","085",65294,64496,798,399,399
"Lagrange County","Lagrange County, Indiana","050","00","2","3","18087","18","087",29477,29230,247,84,163
"Lake County","Lake County, Indiana","050","00","2","3","18089","18","089",475594,456133,19461,12700,6761
"La Porte County","La Porte County, Indiana","050","00","2","3","18091","18","091",107066,105149,1917,1428,489
"Lawrence County","Lawrence County, Indiana","050","00","2","3","18093","18","093",42836,42665,171,82,89
"Madison County","Madison County, Indiana","050","00","2","3","18095","18","095",130669,129755,914,540,374
"Marion County","Marion County, Indiana","050","00","2","3","18097","18","097",797159,781868,15291,8277,7014
"Marshall County","Marshall County, Indiana","050","00","2","3","18099","18","099",42182,41695,487,297,190
"Martin County","Martin County, Indiana","050","00","2","3","18101","18","101",10369,10322,47,29,18
"Miami County","Miami County, Indiana","050","00","2","3","18103","18","103",36897,36477,420,240,180
"Monroe County","Monroe County, Indiana","050","00","2","3","18105","18","105",108978,104242,4736,1252,3484
"Montgomery County","Montgomery County, Indiana","050","00","2","3","18107","18","107",34436,34213,223,91,132
"Morgan County","Morgan County, Indiana","050","00","2","3","18109","18","109",55920,55543,377,204,173
"Newton County","Newton County, Indiana","050","00","2","3","18111","18","111",13551,13342,209,153,56
"Noble County","Noble County, Indiana","050","00","2","3","18113","18","113",37877,37538,339,163,176
"Ohio County","Ohio County, Indiana","050","00","2","3","18115","18","115",5315,5307,8,0,8
"Orange County","Orange County, Indiana","050","00","2","3","18117","18","117",18409,18329,80,44,36
"Owen County","Owen County, Indiana","050","00","2","3","18119","18","119",17281,17192,89,58,31
"Parke County","Parke County, Indiana","050","00","2","3","18121","18","121",15410,15307,103,82,21
"Perry County","Perry County, Indiana","050","00","2","3","18123","18","123",19107,19046,61,46,15
"Pike County","Pike County, Indiana","050","00","2","3","18125","18","125",12509,12469,40,37,3
"Porter County","Porter County, Indiana","050","00","2","3","18127","18","127",128932,125968,2964,1887,1077
"Posey County","Posey County, Indiana","050","00","2","3","18129","18","129",25968,25899,69,50,19
"Pulaski County","Pulaski County, Indiana","050","00","2","3","18131","18","131",12643,12560,83,58,25
"Putnam County","Putnam County, Indiana","050","00","2","3","18133","18","133",30315,30072,243,88,155
"Randolph County","Randolph County, Indiana","050","00","2","3","18135","18","135",27148,27022,126,60,66
"Ripley County","Ripley County, Indiana","050","00","2","3","18137","18","137",24616,24555,61,30,31
"Rush County","Rush County, Indiana","050","00","2","3","18139","18","139",18129,18087,42,23,19
"St. Joseph County","St. Joseph County, Indiana","050","00","2","3","18141","18","141",247052,239628,7424,4138,3286
"Scott County","Scott County, Indiana","050","00","2","3","18143","18","143",20991,20951,40,14,26
"Shelby County","Shelby County, Indiana","050","00","2","3","18145","18","145",40307,40055,252,90,162
"Spencer County","Spencer County, Indiana","050","00","2","3","18147","18","147",19490,19376,114,90,24
"Starke County","Starke County, Indiana","050","00","2","3","18149","18","149",22747,22314,433,290,143
"Steuben County","Steuben County, Indiana","050","00","2","3","18151","18","151",27446,27192,254,118,136
"Sullivan County","Sullivan County, Indiana","050","00","2","3","18153","18","153",18993,18971,22,19,3
"Switzerland County","Switzerland County, Indiana","050","00","2","3","18155","18","155",7738,7709,29,12,17
"Tippecanoe County","Tippecanoe County, Indiana","050","00","2","3","18157","18","157",130598,123918,6680,1562,5118
"Tipton County","Tipton County, Indiana","050","00","2","3","18159","18","159",16119,16053,66,38,28
"Union County","Union County, Indiana","050","00","2","3","18161","18","161",6976,6956,20,14,6
"Vanderburgh County","Vanderburgh County, Indiana","050","00","2","3","18163","18","163",165058,163526,1532,777,755
"Vermillion County","Vermillion County, Indiana","050","00","2","3","18165","18","165",16773,16621,152,125,27
"Vigo County","Vigo County, Indiana","050","00","2","3","18167","18","167",106107,103774,2333,879,1454
"Wabash County","Wabash County, Indiana","050","00","2","3","18169","18","169",35069,34785,284,133,151
"Warren County","Warren County, Indiana","050","00","2","3","18171","18","171",8176,8145,31,11,20
"Warrick County","Warrick County, Indiana","050","00","2","3","18173","18","173",44920,44559,361,227,134
"Washington County","Washington County, Indiana","050","00","2","3","18175","18","175",23717,23626,91,54,37
"Wayne County","Wayne County, Indiana","050","00","2","3","18177","18","177",71951,71501,450,233,217
"Wells County","Wells County, Indiana","050","00","2","3","18179","18","179",25948,25868,80,69,11
"White County","White County, Indiana","050","00","2","3","18181","18","181",23265,23109,156,118,38
"Whitley County","Whitley County, Indiana","050","00","2","3","18183","18","183",27651,27516,135,106,29
"Adair County","Adair County, Iowa","050","00","2","4","19001","19","001",8409,8351,58,17,41
"Adams County","Adams County, Iowa","050","00","2","4","19003","19","003",4866,4852,14,12,2
"Allamakee County","Allamakee County, Iowa","050","00","2","4","19005","19","005",13855,13821,34,28,6
"Appanoose County","Appanoose County, Iowa","050","00","2","4","19007","19","007",13743,13610,133,105,28
"Audubon County","Audubon County, Iowa","050","00","2","4","19009","19","009",7334,7301,33,23,10
"Benton County","Benton County, Iowa","050","00","2","4","19011","19","011",22429,22284,145,95,50
"Black Hawk County","Black Hawk County, Iowa","050","00","2","4","19013","19","013",123798,122163,1635,871,764
"Boone County","Boone County, Iowa","050","00","2","4","19015","19","015",25186,24998,188,93,95
"Bremer County","Bremer County, Iowa","050","00","2","4","19017","19","017",22813,22571,242,128,114
"Buchanan County","Buchanan County, Iowa","050","00","2","4","19019","19","019",20844,20786,58,47,11
"Buena Vista County","Buena Vista County, Iowa","050","00","2","4","19021","19","021",19965,19551,414,115,299
"Butler County","Butler County, Iowa","050","00","2","4","19023","19","023",15731,15599,132,110,22
"Calhoun County","Calhoun County, Iowa","050","00","2","4","19025","19","025",11508,11454,54,40,14
"Carroll County","Carroll County, Iowa","050","00","2","4","19027","19","027",21423,21291,132,98,34
"Cass County","Cass County, Iowa","050","00","2","4","19029","19","029",15128,15094,34,19,15
"Cedar County","Cedar County, Iowa","050","00","2","4","19031","19","031",17381,17289,92,47,45
"Cerro Gordo County","Cerro Gordo County, Iowa","050","00","2","4","19033","19","033",46733,46273,460,304,156
"Cherokee County","Cherokee County, Iowa","050","00","2","4","19035","19","035",14098,13967,131,100,31
"Chickasaw County","Chickasaw County, Iowa","050","00","2","4","19037","19","037",13295,13247,48,33,15
"Clarke County","Clarke County, Iowa","050","00","2","4","19039","19","039",8287,8247,40,26,14
"Clay County","Clay County, Iowa","050","00","2","4","19041","19","041",17585,17507,78,41,37
"Clayton County","Clayton County, Iowa","050","00","2","4","19043","19","043",19054,18941,113,94,19
"Clinton County","Clinton County, Iowa","050","00","2","4","19045","19","045",51040,50619,421,356,65
"Crawford County","Crawford County, Iowa","050","00","2","4","19047","19","047",16775,16653,122,93,29
"Dallas County","Dallas County, Iowa","050","00","2","4","19049","19","049",29755,29543,212,117,95
"Davis County","Davis County, Iowa","050","00","2","4","19051","19","051",8312,8285,27,20,7
"Decatur County","Decatur County, Iowa","050","00","2","4","19053","19","053",8338,8276,62,20,42
"Delaware County","Delaware County, Iowa","050","00","2","4","19055","19","055",18035,17939,96,69,27
"Des Moines County","Des Moines County, Iowa","050","00","2","4","19057","19","057",42614,42176,438,263,175
"Dickinson County","Dickinson County, Iowa","050","00","2","4","19059","19","059",14909,14838,71,61,10
"Dubuque County","Dubuque County, Iowa","050","00","2","4","19061","19","061",86403,85430,973,507,466
"Emmet County","Emmet County, Iowa","050","00","2","4","19063","19","063",11569,11488,81,67,14
"Fayette County","Fayette County, Iowa","050","00","2","4","19065","19","065",21843,21732,111,77,34
"Floyd County","Floyd County, Iowa","050","00","2","4","19067","19","067",17058,16947,111,96,15
"Franklin County","Franklin County, Iowa","050","00","2","4","19069","19","069",11364,11295,69,41,28
"Fremont County","Fremont County, Iowa","050","00","2","4","19071","19","071",8226,8187,39,15,24
"Greene County","Greene County, Iowa","050","00","2","4","19073","19","073",10045,9995,50,28,22
"Grundy County","Grundy County, Iowa","050","00","2","4","19075","19","075",12029,11937,92,76,16
"Guthrie County","Guthrie County, Iowa","050","00","2","4","19077","19","077",10935,10893,42,28,14
"Hamilton County","Hamilton County, Iowa","050","00","2","4","19079","19","079",16071,15933,138,65,73
"Hancock County","Hancock County, Iowa","050","00","2","4","19081","19","081",12638,12582,56,51,5
"Hardin County","Hardin County, Iowa","050","00","2","4","19083","19","083",19094,18951,143,121,22
"Harrison County","Harrison County, Iowa","050","00","2","4","19085","19","085",14730,14627,103,73,30
"Henry County","Henry County, Iowa","050","00","2","4","19087","19","087",19226,18997,229,21,208
"Howard County","Howard County, Iowa","050","00","2","4","19089","19","089",9809,9759,50,32,18
"Humboldt County","Humboldt County, Iowa","050","00","2","4","19091","19","091",10756,10686,70,40,30
"Ida County","Ida County, Iowa","050","00","2","4","19093","19","093",8365,8325,40,21,19
"Iowa County","Iowa County, Iowa","050","00","2","4","19095","19","095",14630,14532,98,67,31
"Jackson County","Jackson County, Iowa","050","00","2","4","19097","19","097",19950,19855,95,83,12
"Jasper County","Jasper County, Iowa","050","00","2","4","19099","19","099",34795,34433,362,214,148
"Jefferson County","Jefferson County, Iowa","050","00","2","4","19101","19","101",16310,15705,605,45,560
"Johnson County","Johnson County, Iowa","050","00","2","4","19103","19","103",96119,90972,5147,1126,4021
"Jones County","Jones County, Iowa","050","00","2","4","19105","19","105",19444,19364,80,58,22
"Keokuk County","Keokuk County, Iowa","050","00","2","4","19107","19","107",11624,11590,34,25,9
"Kossuth County","Kossuth County, Iowa","050","00","2","4","19109","19","109",18591,18466,125,94,31
"Lee County","Lee County, Iowa","050","00","2","4","19111","19","111",38687,38355,332,232,100
"Linn County","Linn County, Iowa","050","00","2","4","19113","19","113",168767,165982,2785,1486,1299
"Louisa County","Louisa County, Iowa","050","00","2","4","19115","19","115",11592,11433,159,43,116
"Lucas County","Lucas County, Iowa","050","00","2","4","19117","19","117",9070,9059,11,6,5
"Lyon County","Lyon County, Iowa","050","00","2","4","19119","19","119",11952,11776,176,161,15
"Madison County","Madison County, Iowa","050","00","2","4","19121","19","121",12483,12387,96,10,86
"Mahaska County","Mahaska County, Iowa","050","00","2","4","19123","19","123",21522,21332,190,135,55
"Marion County","Marion County, Iowa","050","00","2","4","19125","19","125",30001,29613,388,203,185
"Marshall County","Marshall County, Iowa","050","00","2","4","19127","19","127",38276,37815,461,248,213
"Mills County","Mills County, Iowa","050","00","2","4","19129","19","129",13202,13124,78,39,39
"Mitchell County","Mitchell County, Iowa","050","00","2","4","19131","19","131",10928,10847,81,74,7
"Monona County","Monona County, Iowa","050","00","2","4","19133","19","133",10034,9997,37,35,2
"Monroe County","Monroe County, Iowa","050","00","2","4","19135","19","135",8114,8076,38,37,1
"Montgomery County","Montgomery County, Iowa","050","00","2","4","19137","19","137",12076,12047,29,20,9
"Muscatine County","Muscatine County, Iowa","050","00","2","4","19139","19","139",39907,38542,1365,618,747
"O'Brien County","O'Brien County, Iowa","050","00","2","4","19141","19","141",15444,15263,181,141,40
"Osceola County","Osceola County, Iowa","050","00","2","4","19143","19","143",7267,7189,78,78,0
"Page County","Page County, Iowa","050","00","2","4","19145","19","145",16870,16768,102,25,77
"Palo Alto County","Palo Alto County, Iowa","050","00","2","4","19147","19","147",10669,10571,98,77,21
"Plymouth County","Plymouth County, Iowa","050","00","2","4","19149","19","149",23388,23276,112,78,34
"Pocahontas County","Pocahontas County, Iowa","050","00","2","4","19151","19","151",9525,9466,59,43,16
"Polk County","Polk County, Iowa","050","00","2","4","19153","19","153",327140,319269,7871,3957,3914
"Pottawattamie County","Pottawattamie County, Iowa","050","00","2","4","19155","19","155",82628,81917,711,502,209
"Poweshiek County","Poweshiek County, Iowa","050","00","2","4","19157","19","157",19033,18807,226,142,84
"Ringgold County","Ringgold County, Iowa","050","00","2","4","19159","19","159",5420,5375,45,26,19
"Sac County","Sac County, Iowa","050","00","2","4","19161","19","161",12324,12243,81,58,23
"Scott County","Scott County, Iowa","050","00","2","4","19163","19","163",150979,147954,3025,1702,1323
"Shelby County","Shelby County, Iowa","050","00","2","4","19165","19","165",13230,13177,53,43,10
"Sioux County","Sioux County, Iowa","050","00","2","4","19167","19","167",29903,29361,542,321,221
"Story County","Story County, Iowa","050","00","2","4","19169","19","169",74252,69594,4658,735,3923
"Tama County","Tama County, Iowa","050","00","2","4","19171","19","171",17419,17228,191,107,84
"Taylor County","Taylor County, Iowa","050","00","2","4","19173","19","173",7114,7079,35,13,22
"Union County","Union County, Iowa","050","00","2","4","19175","19","175",12750,12692,58,54,4
"Van Buren County","Van Buren County, Iowa","050","00","2","4","19177","19","177",7676,7648,28,17,11
"Wapello County","Wapello County, Iowa","050","00","2","4","19179","19","179",35687,35450,237,131,106
"Warren County","Warren County, Iowa","050","00","2","4","19181","19","181",36033,35821,212,160,52
"Washington County","Washington County, Iowa","050","00","2","4","19183","19","183",19612,19424,188,113,75
"Wayne County","Wayne County, Iowa","050","00","2","4","19185","19","185",7067,7046,21,21,0
"Webster County","Webster County, Iowa","050","00","2","4","19187","19","187",40342,39973,369,282,87
"Winnebago County","Winnebago County, Iowa","050","00","2","4","19189","19","189",12122,11963,159,56,103
"Winneshiek County","Winneshiek County, Iowa","050","00","2","4","19191","19","191",20847,20591,256,82,174
"Woodbury County","Woodbury County, Iowa","050","00","2","4","19193","19","193",98276,95598,2678,1037,1641
"Worth County","Worth County, Iowa","050","00","2","4","19195","19","195",7991,7949,42,35,7
"Wright County","Wright County, Iowa","050","00","2","4","19197","19","197",14269,14155,114,93,21
"Allen County","Allen County, Kansas","050","00","2","4","20001","20","001",14638,14548,90,36,54
"Anderson County","Anderson County, Kansas","050","00","2","4","20003","20","003",7803,7769,34,34,0
"Atchison County","Atchison County, Kansas","050","00","2","4","20005","20","005",16932,16551,381,73,308
"Barber County","Barber County, Kansas","050","00","2","4","20007","20","007",5874,5832,42,21,21
"Barton County","Barton County, Kansas","050","00","2","4","20009","20","009",29382,28977,405,222,183
"Bourbon County","Bourbon County, Kansas","050","00","2","4","20011","20","011",14966,14904,62,32,30
"Brown County","Brown County, Kansas","050","00","2","4","20013","20","013",11128,11044,84,66,18
"Butler County","Butler County, Kansas","050","00","2","4","20015","20","015",50580,50137,443,301,142
"Chase County","Chase County, Kansas","050","00","2","4","20017","20","017",3021,3011,10,2,8
"Chautauqua County","Chautauqua County, Kansas","050","00","2","4","20019","20","019",4407,4396,11,5,6
"Cherokee County","Cherokee County, Kansas","050","00","2","4","20021","20","021",21374,21284,90,55,35
"Cheyenne County","Cheyenne County, Kansas","050","00","2","4","20023","20","023",3243,3221,22,20,2
"Clark County","Clark County, Kansas","050","00","2","4","20025","20","025",2418,2397,21,1,20
"Clay County","Clay County, Kansas","050","00","2","4","20027","20","027",9158,9093,65,44,21
"Cloud County","Cloud County, Kansas","050","00","2","4","20029","20","029",11023,10954,69,55,14
"Coffey County","Coffey County, Kansas","050","00","2","4","20031","20","031",8404,8387,17,17,0
"Comanche County","Comanche County, Kansas","050","00","2","4","20033","20","033",2313,2297,16,0,16
"Cowley County","Cowley County, Kansas","050","00","2","4","20035","20","035",36915,36283,632,272,360
"Crawford County","Crawford County, Kansas","050","00","2","4","20037","20","037",35568,34876,692,245,447
"Decatur County","Decatur County, Kansas","050","00","2","4","20039","20","039",4021,4002,19,9,10
"Dickinson County","Dickinson County, Kansas","050","00","2","4","20041","20","041",18958,18727,231,160,71
"Doniphan County","Doniphan County, Kansas","050","00","2","4","20043","20","043",8134,8108,26,10,16
"Douglas County","Douglas County, Kansas","050","00","2","4","20045","20","045",81798,77670,4128,900,3228
"Edwards County","Edwards County, Kansas","050","00","2","4","20047","20","047",3787,3693,94,26,68
"Elk County","Elk County, Kansas","050","00","2","4","20049","20","049",3327,3316,11,9,2
"Ellis County","Ellis County, Kansas","050","00","2","4","20051","20","051",26004,25767,237,97,140
"Ellsworth County","Ellsworth County, Kansas","050","00","2","4","20053","20","053",6586,6508,78,37,41
"Finney County","Finney County, Kansas","050","00","2","4","20055","20","055",33070,29812,3258,1133,2125
"Ford County","Ford County, Kansas","050","00","2","4","20057","20","057",27463,25020,2443,477,1966
"Franklin County","Franklin County, Kansas","050","00","2","4","20059","20","059",21994,21715,279,149,130
"Geary County","Geary County, Kansas","050","00","2","4","20061","20","061",30453,28413,2040,1242,798
"Gove County","Gove County, Kansas","050","00","2","4","20063","20","063",3231,3217,14,12,2
"Graham County","Graham County, Kansas","050","00","2","4","20065","20","065",3543,3543,0,0,0
"Grant County","Grant County, Kansas","050","00","2","4","20067","20","067",7159,6837,322,90,232
"Gray County","Gray County, Kansas","050","00","2","4","20069","20","069",5396,5225,171,34,137
"Greeley County","Greeley County, Kansas","050","00","2","4","20071","20","071",1774,1730,44,2,42
"Greenwood County","Greenwood County, Kansas","050","00","2","4","20073","20","073",7847,7828,19,12,7
"Hamilton County","Hamilton County, Kansas","050","00","2","4","20075","20","075",2388,2331,57,18,39
"Harper County","Harper County, Kansas","050","00","2","4","20077","20","077",7124,7094,30,13,17
"Harvey County","Harvey County, Kansas","050","00","2","4","20079","20","079",31028,30283,745,353,392
"Haskell County","Haskell County, Kansas","050","00","2","4","20081","20","081",3886,3636,250,107,143
"Hodgeman County","Hodgeman County, Kansas","050","00","2","4","20083","20","083",2177,2169,8,0,8
"Jackson County","Jackson County, Kansas","050","00","2","4","20085","20","085",11525,11497,28,19,9
"Jefferson County","Jefferson County, Kansas","050","00","2","4","20087","20","087",15905,15821,84,55,29
"Jewell County","Jewell County, Kansas","050","00","2","4","20089","20","089",4251,4239,12,12,0
"Johnson County","Johnson County, Kansas","050","00","2","4","20091","20","091",355054,345449,9605,4919,4686
"Kearny County","Kearny County, Kansas","050","00","2","4","20093","20","093",4027,3826,201,46,155
"Kingman County","Kingman County, Kansas","050","00","2","4","20095","20","095",8292,8262,30,17,13
"Kiowa County","Kiowa County, Kansas","050","00","2","4","20097","20","097",3660,3644,16,8,8
"Labette County","Labette County, Kansas","050","00","2","4","20099","20","099",23693,23586,107,61,46
"Lane County","Lane County, Kansas","050","00","2","4","20101","20","101",2375,2349,26,9,17
"Leavenworth County","Leavenworth County, Kansas","050","00","2","4","20103","20","103",64371,62335,2036,1110,926
"Lincoln County","Lincoln County, Kansas","050","00","2","4","20105","20","105",3653,3639,14,9,5
"Linn County","Linn County, Kansas","050","00","2","4","20107","20","107",8254,8227,27,24,3
"Logan County","Logan County, Kansas","050","00","2","4","20109","20","109",3081,3067,14,14,0
"Lyon County","Lyon County, Kansas","050","00","2","4","20111","20","111",34732,33507,1225,397,828
"McPherson County","McPherson County, Kansas","050","00","2","4","20113","20","113",27268,26867,401,159,242
"Marion County","Marion County, Kansas","050","00","2","4","20115","20","115",12888,12605,283,63,220
"Marshall County","Marshall County, Kansas","050","00","2","4","20117","20","117",11705,11579,126,106,20
"Meade County","Meade County, Kansas","050","00","2","4","20119","20","119",4247,4113,134,38,96
"Miami County","Miami County, Kansas","050","00","2","4","20121","20","121",23466,23332,134,100,34
"Mitchell County","Mitchell County, Kansas","050","00","2","4","20123","20","123",7203,7201,2,2,0
"Montgomery County","Montgomery County, Kansas","050","00","2","4","20125","20","125",38816,38541,275,161,114
"Morris County","Morris County, Kansas","050","00","2","4","20127","20","127",6198,6157,41,35,6
"Morton County","Morton County, Kansas","050","00","2","4","20129","20","129",3480,3319,161,56,105
"Nemaha County","Nemaha County, Kansas","050","00","2","4","20131","20","131",10446,10406,40,26,14
"Neosho County","Neosho County, Kansas","050","00","2","4","20133","20","133",17035,16928,107,64,43
"Ness County","Ness County, Kansas","050","00","2","4","20135","20","135",4033,4001,32,23,9
"Norton County","Norton County, Kansas","050","00","2","4","20137","20","137",5947,5875,72,58,14
"Osage County","Osage County, Kansas","050","00","2","4","20139","20","139",15248,15208,40,27,13
"Osborne County","Osborne County, Kansas","050","00","2","4","20141","20","141",4867,4858,9,6,3
"Ottawa County","Ottawa County, Kansas","050","00","2","4","20143","20","143",5634,5615,19,15,4
"Pawnee County","Pawnee County, Kansas","050","00","2","4","20145","20","145",7555,7466,89,74,15
"Phillips County","Phillips County, Kansas","050","00","2","4","20147","20","147",6590,6523,67,62,5
"Pottawatomie County","Pottawatomie County, Kansas","050","00","2","4","20149","20","149",16128,15929,199,61,138
"Pratt County","Pratt County, Kansas","050","00","2","4","20151","20","151",9702,9592,110,42,68
"Rawlins County","Rawlins County, Kansas","050","00","2","4","20153","20","153",3404,3397,7,5,2
"Reno County","Reno County, Kansas","050","00","2","4","20155","20","155",62389,61459,930,494,436
"Republic County","Republic County, Kansas","050","00","2","4","20157","20","157",6482,6462,20,20,0
"Rice County","Rice County, Kansas","050","00","2","4","20159","20","159",10610,10521,89,61,28
"Riley County","Riley County, Kansas","050","00","2","4","20161","20","161",67139,63283,3856,1178,2678
"Rooks County","Rooks County, Kansas","050","00","2","4","20163","20","163",6039,6021,18,10,8
"Rush County","Rush County, Kansas","050","00","2","4","20165","20","165",3842,3833,9,9,0
"Russell County","Russell County, Kansas","050","00","2","4","20167","20","167",7835,7789,46,29,17
"Saline County","Saline County, Kansas","050","00","2","4","20169","20","169",49301,48406,895,398,497
"Scott County","Scott County, Kansas","050","00","2","4","20171","20","171",5289,5219,70,12,58
"Sedgwick County","Sedgwick County, Kansas","050","00","2","4","20173","20","173",403662,389962,13700,6355,7345
"Seward County","Seward County, Kansas","050","00","2","4","20175","20","175",18743,16601,2142,464,1678
"Shawnee County","Shawnee County, Kansas","050","00","2","4","20177","20","177",160976,158738,2238,1327,911
"Sheridan County","Sheridan County, Kansas","050","00","2","4","20179","20","179",3043,3021,22,22,0
"Sherman County","Sherman County, Kansas","050","00","2","4","20181","20","181",6926,6875,51,24,27
"Smith County","Smith County, Kansas","050","00","2","4","20183","20","183",5078,5047,31,31,0
"Stafford County","Stafford County, Kansas","050","00","2","4","20185","20","185",5365,5314,51,41,10
"Stanton County","Stanton County, Kansas","050","00","2","4","20187","20","187",2333,2186,147,42,105
"Stevens County","Stevens County, Kansas","050","00","2","4","20189","20","189",5048,4818,230,102,128
"Sumner County","Sumner County, Kansas","050","00","2","4","20191","20","191",25841,25532,309,184,125
"Thomas County","Thomas County, Kansas","050","00","2","4","20193","20","193",8258,8203,55,11,44
"Trego County","Trego County, Kansas","050","00","2","4","20195","20","195",3694,3663,31,27,4
"Wabaunsee County","Wabaunsee County, Kansas","050","00","2","4","20197","20","197",6603,6544,59,44,15
"Wallace County","Wallace County, Kansas","050","00","2","4","20199","20","199",1821,1808,13,7,6
"Washington County","Washington County, Kansas","050","00","2","4","20201","20","201",7073,7050,23,18,5
"Wichita County","Wichita County, Kansas","050","00","2","4","20203","20","203",2758,2676,82,44,38
"Wilson County","Wilson County, Kansas","050","00","2","4","20205","20","205",10289,10231,58,38,20
"Woodson County","Woodson County, Kansas","050","00","2","4","20207","20","207",4116,4101,15,11,4
"Wyandotte County","Wyandotte County, Kansas","050","00","2","4","20209","20","209",161993,157806,4187,1959,2228
"Adair County","Adair County, Kentucky","050","00","3","6","21001","21","001",15360,15347,13,13,0
"Allen County","Allen County, Kentucky","050","00","3","6","21003","21","003",14628,14596,32,27,5
"Anderson County","Anderson County, Kentucky","050","00","3","6","21005","21","005",14571,14517,54,16,38
"Ballard County","Ballard County, Kentucky","050","00","3","6","21007","21","007",7902,7881,21,15,6
"Barren County","Barren County, Kentucky","050","00","3","6","21009","21","009",34001,33840,161,87,74
"Bath County","Bath County, Kentucky","050","00","3","6","21011","21","011",9692,9675,17,15,2
"Bell County","Bell County, Kentucky","050","00","3","6","21013","21","013",31506,31428,78,13,65
"Boone County","Boone County, Kentucky","050","00","3","6","21015","21","015",57589,56926,663,236,427
"Bourbon County","Bourbon County, Kentucky","050","00","3","6","21017","21","017",19236,19153,83,28,55
"Boyd County","Boyd County, Kentucky","050","00","3","6","21019","21","019",51150,50583,567,171,396
"Boyle County","Boyle County, Kentucky","050","00","3","6","21021","21","021",25641,25534,107,29,78
"Bracken County","Bracken County, Kentucky","050","00","3","6","21023","21","023",7766,7756,10,10,0
"Breathitt County","Breathitt County, Kentucky","050","00","3","6","21025","21","025",15703,15664,39,20,19
"Breckinridge County","Breckinridge County, Kentucky","050","00","3","6","21027","21","027",16312,16296,16,5,11
"Bullitt County","Bullitt County, Kentucky","050","00","3","6","21029","21","029",47567,47318,249,137,112
"Butler County","Butler County, Kentucky","050","00","3","6","21031","21","031",11245,11214,31,19,12
"Caldwell County","Caldwell County, Kentucky","050","00","3","6","21033","21","033",13232,13131,101,22,79
"Calloway County","Calloway County, Kentucky","050","00","3","6","21035","21","035",30735,30383,352,147,205
"Campbell County","Campbell County, Kentucky","050","00","3","6","21037","21","037",83866,83318,548,318,230
"Carlisle County","Carlisle County, Kentucky","050","00","3","6","21039","21","039",5238,5238,0,0,0
"Carroll County","Carroll County, Kentucky","050","00","3","6","21041","21","041",9292,9222,70,50,20
"Carter County","Carter County, Kentucky","050","00","3","6","21043","21","043",24340,24293,47,34,13
"Casey County","Casey County, Kentucky","050","00","3","6","21045","21","045",14211,14133,78,29,49
"Christian County","Christian County, Kentucky","050","00","3","6","21047","21","047",68941,67287,1654,717,937
"Clark County","Clark County, Kentucky","050","00","3","6","21049","21","049",29496,29356,140,74,66
"Clay County","Clay County, Kentucky","050","00","3","6","21051","21","051",21746,21710,36,21,15
"Clinton County","Clinton County, Kentucky","050","00","3","6","21053","21","053",9135,9128,7,7,0
"Crittenden County","Crittenden County, Kentucky","050","00","3","6","21055","21","055",9196,9196,0,0,0
"Cumberland County","Cumberland County, Kentucky","050","00","3","6","21057","21","057",6784,6779,5,3,2
"Daviess County","Daviess County, Kentucky","050","00","3","6","21059","21","059",87189,86837,352,150,202
"Edmonson County","Edmonson County, Kentucky","050","00","3","6","21061","21","061",10357,10343,14,8,6
"Elliott County","Elliott County, Kentucky","050","00","3","6","21063","21","063",6455,6455,0,0,0
"Estill County","Estill County, Kentucky","050","00","3","6","21065","21","065",14614,14586,28,17,11
"Fayette County","Fayette County, Kentucky","050","00","3","6","21067","21","067",225366,218738,6628,2044,4584
"Fleming County","Fleming County, Kentucky","050","00","3","6","21069","21","069",12292,12243,49,34,15
"Floyd County","Floyd County, Kentucky","050","00","3","6","21071","21","071",43586,43546,40,0,40
"Franklin County","Franklin County, Kentucky","050","00","3","6","21073","21","073",43781,43394,387,242,145
"Fulton County","Fulton County, Kentucky","050","00","3","6","21075","21","075",8271,8207,64,27,37
"Gallatin County","Gallatin County, Kentucky","050","00","3","6","21077","21","077",5393,5393,0,0,0
"Garrard County","Garrard County, Kentucky","050","00","3","6","21079","21","079",11579,11559,20,20,0
"Grant County","Grant County, Kentucky","050","00","3","6","21081","21","081",15737,15701,36,11,25
"Graves County","Graves County, Kentucky","050","00","3","6","21083","21","083",33550,33459,91,29,62
"Grayson County","Grayson County, Kentucky","050","00","3","6","21085","21","085",21050,20950,100,54,46
"Green County","Green County, Kentucky","050","00","3","6","21087","21","087",10371,10326,45,14,31
"Greenup County","Greenup County, Kentucky","050","00","3","6","21089","21","089",36742,36593,149,82,67
"Hancock County","Hancock County, Kentucky","050","00","3","6","21091","21","091",7864,7823,41,19,22
"Hardin County","Hardin County, Kentucky","050","00","3","6","21093","21","093",89240,86099,3141,1705,1436
"Harlan County","Harlan County, Kentucky","050","00","3","6","21095","21","095",36574,36502,72,61,11
"Harrison County","Harrison County, Kentucky","050","00","3","6","21097","21","097",16248,16167,81,61,20
"Hart County","Hart County, Kentucky","050","00","3","6","21099","21","099",14890,14838,52,18,34
"Henderson County","Henderson County, Kentucky","050","00","3","6","21101","21","101",43044,42841,203,131,72
"Henry County","Henry County, Kentucky","050","00","3","6","21103","21","103",12823,12786,37,32,5
"Hickman County","Hickman County, Kentucky","050","00","3","6","21105","21","105",5566,5557,9,9,0
"Hopkins County","Hopkins County, Kentucky","050","00","3","6","21107","21","107",46126,45903,223,134,89
"Jackson County","Jackson County, Kentucky","050","00","3","6","21109","21","109",11955,11947,8,2,6
"Jefferson County","Jefferson County, Kentucky","050","00","3","6","21111","21","111",664937,655212,9725,5034,4691
"Jessamine County","Jessamine County, Kentucky","050","00","3","6","21113","21","113",30508,30131,377,127,250
"Johnson County","Johnson County, Kentucky","050","00","3","6","21115","21","115",23248,23168,80,56,24
"Kenton County","Kenton County, Kentucky","050","00","3","6","21117","21","117",142031,140798,1233,818,415
"Knott County","Knott County, Kentucky","050","00","3","6","21119","21","119",17906,17880,26,3,23
"Knox County","Knox County, Kentucky","050","00","3","6","21121","21","121",29676,29614,62,19,43
"Larue County","Larue County, Kentucky","050","00","3","6","21123","21","123",11679,11671,8,0,8
"Laurel County","Laurel County, Kentucky","050","00","3","6","21125","21","125",43438,43328,110,82,28
"Lawrence County","Lawrence County, Kentucky","050","00","3","6","21127","21","127",13998,13955,43,27,16
"Lee County","Lee County, Kentucky","050","00","3","6","21129","21","129",7422,7409,13,8,5
"Leslie County","Leslie County, Kentucky","050","00","3","6","21131","21","131",13642,13620,22,15,7
"Letcher County","Letcher County, Kentucky","050","00","3","6","21133","21","133",27000,26911,89,43,46
"Lewis County","Lewis County, Kentucky","050","00","3","6","21135","21","135",13029,13020,9,5,4
"Lincoln County","Lincoln County, Kentucky","050","00","3","6","21137","21","137",20045,20010,35,35,0
"Livingston County","Livingston County, Kentucky","050","00","3","6","21139","21","139",9062,9033,29,25,4
"Logan County","Logan County, Kentucky","050","00","3","6","21141","21","141",24416,24345,71,53,18
"Lyon County","Lyon County, Kentucky","050","00","3","6","21143","21","143",6624,6605,19,10,9
"McCracken County","McCracken County, Kentucky","050","00","3","6","21145","21","145",62879,62404,475,256,219
"McCreary County","McCreary County, Kentucky","050","00","3","6","21147","21","147",15603,15557,46,31,15
"McLean County","McLean County, Kentucky","050","00","3","6","21149","21","149",9628,9614,14,12,2
"Madison County","Madison County, Kentucky","050","00","3","6","21151","21","151",57508,56926,582,195,387
"Magoffin County","Magoffin County, Kentucky","050","00","3","6","21153","21","153",13077,13077,0,0,0
"Marion County","Marion County, Kentucky","050","00","3","6","21155","21","155",16499,16465,34,29,5
"Marshall County","Marshall County, Kentucky","050","00","3","6","21157","21","157",27205,27084,121,64,57
"Martin County","Martin County, Kentucky","050","00","3","6","21159","21","159",12526,12520,6,6,0
"Mason County","Mason County, Kentucky","050","00","3","6","21161","21","161",16666,16617,49,21,28
"Meade County","Meade County, Kentucky","050","00","3","6","21163","21","163",24170,23681,489,230,259
"Menifee County","Menifee County, Kentucky","050","00","3","6","21165","21","165",5092,5083,9,2,7
"Mercer County","Mercer County, Kentucky","050","00","3","6","21167","21","167",19148,19067,81,13,68
"Metcalfe County","Metcalfe County, Kentucky","050","00","3","6","21169","21","169",8963,8948,15,5,10
"Monroe County","Monroe County, Kentucky","050","00","3","6","21171","21","171",11401,11374,27,15,12
"Montgomery County","Montgomery County, Kentucky","050","00","3","6","21173","21","173",19561,19514,47,34,13
"Morgan County","Morgan County, Kentucky","050","00","3","6","21175","21","175",11648,11641,7,2,5
"Muhlenberg County","Muhlenberg County, Kentucky","050","00","3","6","21177","21","177",31318,31279,39,37,2
"Nelson County","Nelson County, Kentucky","050","00","3","6","21179","21","179",29710,29576,134,28,106
"Nicholas County","Nicholas County, Kentucky","050","00","3","6","21181","21","181",6725,6723,2,2,0
"Ohio County","Ohio County, Kentucky","050","00","3","6","21183","21","183",21105,21040,65,49,16
"Oldham County","Oldham County, Kentucky","050","00","3","6","21185","21","185",33263,32846,417,191,226
"Owen County","Owen County, Kentucky","050","00","3","6","21187","21","187",9035,9021,14,14,0
"Owsley County","Owsley County, Kentucky","050","00","3","6","21189","21","189",5036,5023,13,7,6
"Pendleton County","Pendleton County, Kentucky","050","00","3","6","21191","21","191",12036,12021,15,11,4
"Perry County","Perry County, Kentucky","050","00","3","6","21193","21","193",30283,30216,67,26,41
"Pike County","Pike County, Kentucky","050","00","3","6","21195","21","195",72583,72371,212,117,95
"Powell County","Powell County, Kentucky","050","00","3","6","21197","21","197",11686,11672,14,14,0
"Pulaski County","Pulaski County, Kentucky","050","00","3","6","21199","21","199",49489,49350,139,105,34
"Robertson County","Robertson County, Kentucky","050","00","3","6","21201","21","201",2124,2124,0,0,0
"Rockcastle County","Rockcastle County, Kentucky","050","00","3","6","21203","21","203",14803,14748,55,35,20
"Rowan County","Rowan County, Kentucky","050","00","3","6","21205","21","205",20353,20200,153,43,110
"Russell County","Russell County, Kentucky","050","00","3","6","21207","21","207",14716,14675,41,33,8
"Scott County","Scott County, Kentucky","050","00","3","6","21209","21","209",23867,23769,98,44,54
"Shelby County","Shelby County, Kentucky","050","00","3","6","21211","21","211",24824,24738,86,61,25
"Simpson County","Simpson County, Kentucky","050","00","3","6","21213","21","213",15145,15053,92,39,53
"Spencer County","Spencer County, Kentucky","050","00","3","6","21215","21","215",6801,6781,20,13,7
"Taylor County","Taylor County, Kentucky","050","00","3","6","21217","21","217",21146,21084,62,33,29
"Todd County","Todd County, Kentucky","050","00","3","6","21219","21","219",10940,10914,26,23,3
"Trigg County","Trigg County, Kentucky","050","00","3","6","21221","21","221",10361,10281,80,37,43
"Trimble County","Trimble County, Kentucky","050","00","3","6","21223","21","223",6090,6063,27,18,9
"Union County","Union County, Kentucky","050","00","3","6","21225","21","225",16557,16495,62,40,22
"Warren County","Warren County, Kentucky","050","00","3","6","21227","21","227",76673,75753,920,320,600
"Washington County","Washington County, Kentucky","050","00","3","6","21229","21","229",10441,10430,11,0,11
"Wayne County","Wayne County, Kentucky","050","00","3","6","21231","21","231",17468,17461,7,0,7
"Webster County","Webster County, Kentucky","050","00","3","6","21233","21","233",13955,13912,43,27,16
"Whitley County","Whitley County, Kentucky","050","00","3","6","21235","21","235",33326,33225,101,46,55
"Wolfe County","Wolfe County, Kentucky","050","00","3","6","21237","21","237",6503,6503,0,0,0
"Woodford County","Woodford County, Kentucky","050","00","3","6","21239","21","239",19955,19853,102,35,67
"Acadia Parish","Acadia Parish, Louisiana","050","00","3","7","22001","22","001",55882,55710,172,60,112
"Allen Parish","Allen Parish, Louisiana","050","00","3","7","22003","22","003",21226,20561,665,95,570
"Ascension Parish","Ascension Parish, Louisiana","050","00","3","7","22005","22","005",58214,57543,671,330,341
"Assumption Parish","Assumption Parish, Louisiana","050","00","3","7","22007","22","007",22753,22666,87,8,79
"Avoyelles Parish","Avoyelles Parish, Louisiana","050","00","3","7","22009","22","009",39159,38757,402,113,289
"Beauregard Parish","Beauregard Parish, Louisiana","050","00","3","7","22011","22","011",30083,29639,444,224,220
"Bienville Parish","Bienville Parish, Louisiana","050","00","3","7","22013","22","013",15979,15959,20,11,9
"Bossier Parish","Bossier Parish, Louisiana","050","00","3","7","22015","22","015",86088,84416,1672,1143,529
"Caddo Parish","Caddo Parish, Louisiana","050","00","3","7","22017","22","017",248253,245972,2281,1264,1017
"Calcasieu Parish","Calcasieu Parish, Louisiana","050","00","3","7","22019","22","019",168134,166961,1173,656,517
"Caldwell Parish","Caldwell Parish, Louisiana","050","00","3","7","22021","22","021",9810,9732,78,25,53
"Cameron Parish","Cameron Parish, Louisiana","050","00","3","7","22023","22","023",9260,9141,119,86,33
"Catahoula Parish","Catahoula Parish, Louisiana","050","00","3","7","22025","22","025",11065,11061,4,2,2
"Claiborne Parish","Claiborne Parish, Louisiana","050","00","3","7","22027","22","027",17405,17376,29,19,10
"Concordia Parish","Concordia Parish, Louisiana","050","00","3","7","22029","22","029",20828,20762,66,50,16
"De Soto Parish","De Soto Parish, Louisiana","050","00","3","7","22031","22","031",25346,25240,106,83,23
"East Baton Rouge Parish","East Baton Rouge Parish, Louisiana","050","00","3","7","22033","22","033",380105,370668,9437,3060,6377
"East Carroll Parish","East Carroll Parish, Louisiana","050","00","3","7","22035","22","035",9709,9681,28,22,6
"East Feliciana Parish","East Feliciana Parish, Louisiana","050","00","3","7","22037","22","037",19211,19056,155,58,97
"Evangeline Parish","Evangeline Parish, Louisiana","050","00","3","7","22039","22","039",33274,33195,79,16,63
"Franklin Parish","Franklin Parish, Louisiana","050","00","3","7","22041","22","041",22387,22361,26,23,3
"Grant Parish","Grant Parish, Louisiana","050","00","3","7","22043","22","043",17526,17453,73,40,33
"Iberia Parish","Iberia Parish, Louisiana","050","00","3","7","22045","22","045",68297,67278,1019,469,550
"Iberville Parish","Iberville Parish, Louisiana","050","00","3","7","22047","22","047",31049,30862,187,115,72
"Jackson Parish","Jackson Parish, Louisiana","050","00","3","7","22049","22","049",15705,15695,10,4,6
"Jefferson Parish","Jefferson Parish, Louisiana","050","00","3","7","22051","22","051",448306,421971,26335,11956,14379
"Jefferson Davis Parish","Jefferson Davis Parish, Louisiana","050","00","3","7","22053","22","053",30722,30593,129,83,46
"Lafayette Parish","Lafayette Parish, Louisiana","050","00","3","7","22055","22","055",164762,161652,3110,1239,1871
"Lafourche Parish","Lafourche Parish, Louisiana","050","00","3","7","22057","22","057",85860,85216,644,233,411
"La Salle Parish","La Salle Parish, Louisiana","050","00","3","7","22059","22","059",13662,13597,65,43,22
"Lincoln Parish","Lincoln Parish, Louisiana","050","00","3","7","22061","22","061",41745,40940,805,148,657
"Livingston Parish","Livingston Parish, Louisiana","050","00","3","7","22063","22","063",70526,70251,275,186,89
"Madison Parish","Madison Parish, Louisiana","050","00","3","7","22065","22","065",12463,12439,24,17,7
"Morehouse Parish","Morehouse Parish, Louisiana","050","00","3","7","22067","22","067",31938,31898,40,32,8
"Natchitoches Parish","Natchitoches Parish, Louisiana","050","00","3","7","22069","22","069",36689,36435,254,129,125
"Orleans Parish","Orleans Parish, Louisiana","050","00","3","7","22071","22","071",496938,476154,20784,8448,12336
"Ouachita Parish","Ouachita Parish, Louisiana","050","00","3","7","22073","22","073",142191,140930,1261,455,806
"Plaquemines Parish","Plaquemines Parish, Louisiana","050","00","3","7","22075","22","075",25575,24895,680,142,538
"Pointe Coupee Parish","Pointe Coupee Parish, Louisiana","050","00","3","7","22077","22","077",22540,22412,128,58,70
"Rapides Parish","Rapides Parish, Louisiana","050","00","3","7","22079","22","079",131556,129986,1570,883,687
"Red River Parish","Red River Parish, Louisiana","050","00","3","7","22081","22","081",9387,9380,7,7,0
"Richland Parish","Richland Parish, Louisiana","050","00","3","7","22083","22","083",20629,20574,55,33,22
"Sabine Parish","Sabine Parish, Louisiana","050","00","3","7","22085","22","085",22646,22547,99,73,26
"St. Bernard Parish","St. Bernard Parish, Louisiana","050","00","3","7","22087","22","087",66631,65215,1416,724,692
"St. Charles Parish","St. Charles Parish, Louisiana","050","00","3","7","22089","22","089",42437,41906,531,278,253
"St. Helena Parish","St. Helena Parish, Louisiana","050","00","3","7","22091","22","091",9874,9857,17,10,7
"St. James Parish","St. James Parish, Louisiana","050","00","3","7","22093","22","093",20879,20818,61,50,11
"St. John the Baptist Parish","St. John the Baptist Parish, Louisiana","050","00","3","7","22095","22","095",39996,39273,723,452,271
"St. Landry Parish","St. Landry Parish, Louisiana","050","00","3","7","22097","22","097",80331,80120,211,168,43
"St. Martin Parish","St. Martin Parish, Louisiana","050","00","3","7","22099","22","099",43978,43581,397,86,311
"St. Mary Parish","St. Mary Parish, Louisiana","050","00","3","7","22101","22","101",58086,56922,1164,399,765
"St. Tammany Parish","St. Tammany Parish, Louisiana","050","00","3","7","22103","22","103",144508,142033,2475,1416,1059
"Tangipahoa Parish","Tangipahoa Parish, Louisiana","050","00","3","7","22105","22","105",85709,85005,704,341,363
"Tensas Parish","Tensas Parish, Louisiana","050","00","3","7","22107","22","107",7103,7075,28,25,3
"Terrebonne Parish","Terrebonne Parish, Louisiana","050","00","3","7","22109","22","109",96982,96072,910,382,528
"Union Parish","Union Parish, Louisiana","050","00","3","7","22111","22","111",20690,20607,83,61,22
"Vermilion Parish","Vermilion Parish, Louisiana","050","00","3","7","22113","22","113",50055,49435,620,209,411
"Vernon Parish","Vernon Parish, Louisiana","050","00","3","7","22115","22","115",61961,59748,2213,1010,1203
"Washington Parish","Washington Parish, Louisiana","050","00","3","7","22117","22","117",43185,42987,198,86,112
"Webster Parish","Webster Parish, Louisiana","050","00","3","7","22119","22","119",41989,41850,139,100,39
"West Baton Rouge Parish","West Baton Rouge Parish, Louisiana","050","00","3","7","22121","22","121",19419,19344,75,69,6
"West Carroll Parish","West Carroll Parish, Louisiana","050","00","3","7","22123","22","123",12093,12075,18,11,7
"West Feliciana Parish","West Feliciana Parish, Louisiana","050","00","3","7","22125","22","125",12915,12833,82,27,55
"Winn Parish","Winn Parish, Louisiana","050","00","3","7","22127","22","127",16269,16195,74,37,37
"Androscoggin County","Androscoggin County, Maine","050","00","1","1","23001","23","001",105259,101606,3653,2564,1089
"Aroostook County","Aroostook County, Maine","050","00","1","1","23003","23","003",86936,82220,4716,2434,2282
"Cumberland County","Cumberland County, Maine","050","00","1","1","23005","23","005",243135,235184,7951,4483,3468
"Franklin County","Franklin County, Maine","050","00","1","1","23007","23","007",29008,28468,540,329,211
"Hancock County","Hancock County, Maine","050","00","1","1","23009","23","009",46948,45856,1092,631,461
"Kennebec County","Kennebec County, Maine","050","00","1","1","23011","23","011",115904,112710,3194,2036,1158
"Knox County","Knox County, Maine","050","00","1","1","23013","23","013",36310,35749,561,359,202
"Lincoln County","Lincoln County, Maine","050","00","1","1","23015","23","015",30357,29720,637,379,258
"Oxford County","Oxford County, Maine","050","00","1","1","23017","23","017",52602,51665,937,661,276
"Penobscot County","Penobscot County, Maine","050","00","1","1","23019","23","019",146601,142703,3898,2053,1845
"Piscataquis County","Piscataquis County, Maine","050","00","1","1","23021","23","021",18653,18264,389,189,200
"Sagadahoc County","Sagadahoc County, Maine","050","00","1","1","23023","23","023",33535,32703,832,553,279
"Somerset County","Somerset County, Maine","050","00","1","1","23025","23","025",49767,48813,954,573,381
"Waldo County","Waldo County, Maine","050","00","1","1","23027","23","027",33018,32503,515,340,175
"Washington County","Washington County, Maine","050","00","1","1","23029","23","029",35308,33752,1556,760,796
"York County","York County, Maine","050","00","1","1","23031","23","031",164587,159716,4871,2937,1934
"Allegany County","Allegany County, Maryland","050","00","3","5","24001","24","001",74946,74169,777,501,276
"Anne Arundel County","Anne Arundel County, Maryland","050","00","3","5","24003","24","003",427239,413972,13267,7802,5465
"Baltimore County","Baltimore County, Maryland","050","00","3","5","24005","24","005",692134,659631,32503,17321,15182
"Calvert County","Calvert County, Maryland","050","00","3","5","24009","24","009",51372,50525,847,613,234
"Caroline County","Caroline County, Maryland","050","00","3","5","24011","24","011",27035,26727,308,189,119
"Carroll County","Carroll County, Maryland","050","00","3","5","24013","24","013",123372,121817,1555,902,653
"Cecil County","Cecil County, Maryland","050","00","3","5","24015","24","015",71347,70315,1032,649,383
"Charles County","Charles County, Maryland","050","00","3","5","24017","24","017",101154,99072,2082,1285,797
"Dorchester County","Dorchester County, Maryland","050","00","3","5","24019","24","019",30236,29848,388,214,174
"Frederick County","Frederick County, Maryland","050","00","3","5","24021","24","021",150208,147135,3073,1396,1677
"Garrett County","Garrett County, Maryland","050","00","3","5","24023","24","023",28138,28050,88,60,28
"Harford County","Harford County, Maryland","050","00","3","5","24025","24","025",182132,177112,5020,3379,1641
"Howard County","Howard County, Maryland","050","00","3","5","24027","24","027",187328,175961,11367,5765,5602
"Kent County","Kent County, Maryland","050","00","3","5","24029","24","029",17842,17254,588,180,408
"Montgomery County","Montgomery County, Maryland","050","00","3","5","24031","24","031",757027,615861,141166,48289,92877
"Prince George's County","Prince George's County, Maryland","050","00","3","5","24033","24","033",729268,659459,69809,24057,45752
"Queen Anne's County","Queen Anne's County, Maryland","050","00","3","5","24035","24","035",33953,33479,474,299,175
"St. Mary's County","St. Mary's County, Maryland","050","00","3","5","24037","24","037",75974,74431,1543,916,627
"Somerset County","Somerset County, Maryland","050","00","3","5","24039","24","039",23440,23221,219,72,147
"Talbot County","Talbot County, Maryland","050","00","3","5","24041","24","041",30549,29942,607,312,295
"Washington County","Washington County, Maryland","050","00","3","5","24043","24","043",121393,119928,1465,847,618
"Wicomico County","Wicomico County, Maryland","050","00","3","5","24045","24","045",74339,73013,1326,653,673
"Worcester County","Worcester County, Maryland","050","00","3","5","24047","24","047",35028,34505,523,357,166
"Baltimore city","Baltimore city, Maryland","050","00","3","5","24510","24","510",736014,712547,23467,10947,12520
"Barnstable County","Barnstable County, Massachusetts","050","00","1","1","25001","25","001",186605,178109,8496,5438,3058
"Berkshire County","Berkshire County, Massachusetts","050","00","1","1","25003","25","003",139352,134386,4966,3392,1574
"Bristol County","Bristol County, Massachusetts","050","00","1","1","25005","25","005",506325,444700,61625,27308,34317
"Dukes County","Dukes County, Massachusetts","050","00","1","1","25007","25","007",11639,11303,336,228,108
"Essex County","Essex County, Massachusetts","050","00","1","1","25009","25","009",670080,613350,56730,26346,30384
"Franklin County","Franklin County, Massachusetts","050","00","1","1","25011","25","011",70092,68481,1611,902,709
"Hampden County","Hampden County, Massachusetts","050","00","1","1","25013","25","013",456310,427794,28516,15974,12542
"Hampshire County","Hampshire County, Massachusetts","050","00","1","1","25015","25","015",146568,137370,9198,3257,5941
"Middlesex County","Middlesex County, Massachusetts","050","00","1","1","25017","25","017",1398468,1240711,157757,72519,85238
"Nantucket County","Nantucket County, Massachusetts","050","00","1","1","25019","25","019",6012,5773,239,79,160
"Norfolk County","Norfolk County, Massachusetts","050","00","1","1","25021","25","021",616087,562880,53207,29496,23711
"Plymouth County","Plymouth County, Massachusetts","050","00","1","1","25023","25","023",435276,414134,21142,10732,10410
"Suffolk County","Suffolk County, Massachusetts","050","00","1","1","25025","25","025",663906,536699,127207,43986,83221
"Worcester County","Worcester County, Massachusetts","050","00","1","1","25027","25","027",709705,667002,42703,22422,20281
"Alcona County","Alcona County, Michigan","050","00","2","3","26001","26","001",10145,9974,171,141,30
"Alger County","Alger County, Michigan","050","00","2","3","26003","26","003",8972,8874,98,77,21
"Allegan County","Allegan County, Michigan","050","00","2","3","26005","26","005",90509,88831,1678,891,787
"Alpena County","Alpena County, Michigan","050","00","2","3","26007","26","007",30605,30223,382,218,164
"Antrim County","Antrim County, Michigan","050","00","2","3","26009","26","009",18185,17915,270,179,91
"Arenac County","Arenac County, Michigan","050","00","2","3","26011","26","011",14931,14741,190,145,45
"Baraga County","Baraga County, Michigan","050","00","2","3","26013","26","013",7954,7849,105,84,21
"Barry County","Barry County, Michigan","050","00","2","3","26015","26","015",50057,49610,447,289,158
"Bay County","Bay County, Michigan","050","00","2","3","26017","26","017",111723,110597,1126,885,241
"Benzie County","Benzie County, Michigan","050","00","2","3","26019","26","019",12200,12047,153,113,40
"Berrien County","Berrien County, Michigan","050","00","2","3","26021","26","021",161378,155951,5427,3038,2389
"Branch County","Branch County, Michigan","050","00","2","3","26023","26","023",41502,41100,402,274,128
"Calhoun County","Calhoun County, Michigan","050","00","2","3","26025","26","025",135982,133691,2291,1384,907
"Cass County","Cass County, Michigan","050","00","2","3","26027","26","027",49477,48822,655,390,265
"Charlevoix County","Charlevoix County, Michigan","050","00","2","3","26029","26","029",21468,21154,314,239,75
"Cheboygan County","Cheboygan County, Michigan","050","00","2","3","26031","26","031",21398,21059,339,281,58
"Chippewa County","Chippewa County, Michigan","050","00","2","3","26033","26","033",34604,33675,929,474,455
"Clare County","Clare County, Michigan","050","00","2","3","26035","26","035",24952,24634,318,225,93
"Clinton County","Clinton County, Michigan","050","00","2","3","26037","26","037",57883,57410,473,373,100
"Crawford County","Crawford County, Michigan","050","00","2","3","26039","26","039",12260,12054,206,165,41
"Delta County","Delta County, Michigan","050","00","2","3","26041","26","041",37780,37431,349,233,116
"Dickinson County","Dickinson County, Michigan","050","00","2","3","26043","26","043",26831,26539,292,227,65
"Eaton County","Eaton County, Michigan","050","00","2","3","26045","26","045",92879,91342,1537,982,555
"Emmet County","Emmet County, Michigan","050","00","2","3","26047","26","047",25040,24666,374,268,106
"Genesee County","Genesee County, Michigan","050","00","2","3","26049","26","049",430459,421796,8663,5947,2716
"Gladwin County","Gladwin County, Michigan","050","00","2","3","26051","26","051",21896,21632,264,224,40
"Gogebic County","Gogebic County, Michigan","050","00","2","3","26053","26","053",18052,17695,357,303,54
"Grand Traverse County","Grand Traverse County, Michigan","050","00","2","3","26055","26","055",64273,63162,1111,748,363
"Gratiot County","Gratiot County, Michigan","050","00","2","3","26057","26","057",38982,38577,405,235,170
"Hillsdale County","Hillsdale County, Michigan","050","00","2","3","26059","26","059",43431,43018,413,261,152
"Houghton County","Houghton County, Michigan","050","00","2","3","26061","26","061",35446,34469,977,309,668
"Huron County","Huron County, Michigan","050","00","2","3","26063","26","063",34951,34512,439,318,121
"Ingham County","Ingham County, Michigan","050","00","2","3","26065","26","065",281912,269633,12279,4268,8011
"Ionia County","Ionia County, Michigan","050","00","2","3","26067","26","067",57024,56515,509,267,242
"Iosco County","Iosco County, Michigan","050","00","2","3","26069","26","069",30209,29491,718,517,201
"Iron County","Iron County, Michigan","050","00","2","3","26071","26","071",13175,12823,352,300,52
"Isabella County","Isabella County, Michigan","050","00","2","3","26073","26","073",54624,53727,897,371,526
"Jackson County","Jackson County, Michigan","050","00","2","3","26075","26","075",149756,147706,2050,1182,868
"Kalamazoo County","Kalamazoo County, Michigan","050","00","2","3","26077","26","077",223411,215857,7554,3655,3899
"Kalkaska County","Kalkaska County, Michigan","050","00","2","3","26079","26","079",13497,13360,137,105,32
"Kent County","Kent County, Michigan","050","00","2","3","26081","26","081",500631,484833,15798,8403,7395
"Keweenaw County","Keweenaw County, Michigan","050","00","2","3","26083","26","083",1701,1667,34,28,6
"Lake County","Lake County, Michigan","050","00","2","3","26085","26","085",8583,8451,132,87,45
"Lapeer County","Lapeer County, Michigan","050","00","2","3","26087","26","087",74768,73524,1244,751,493
"Leelanau County","Leelanau County, Michigan","050","00","2","3","26089","26","089",16527,16282,245,161,84
"Lenawee County","Lenawee County, Michigan","050","00","2","3","26091","26","091",91476,89993,1483,802,681
"Livingston County","Livingston County, Michigan","050","00","2","3","26093","26","093",115645,112908,2737,1663,1074
"Luce County","Luce County, Michigan","050","00","2","3","26095","26","095",5763,5677,86,51,35
"Mackinac County","Mackinac County, Michigan","050","00","2","3","26097","26","097",10674,10554,120,101,19
"Macomb County","Macomb County, Michigan","050","00","2","3","26099","26","099",717400,668291,49109,30380,18729
"Manistee County","Manistee County, Michigan","050","00","2","3","26101","26","101",21265,21052,213,154,59
"Marquette County","Marquette County, Michigan","050","00","2","3","26103","26","103",70887,69713,1174,764,410
"Mason County","Mason County, Michigan","050","00","2","3","26105","26","105",25537,25257,280,217,63
"Mecosta County","Mecosta County, Michigan","050","00","2","3","26107","26","107",37308,36598,710,272,438
"Menominee County","Menominee County, Michigan","050","00","2","3","26109","26","109",24920,24664,256,185,71
"Midland County","Midland County, Michigan","050","00","2","3","26111","26","111",75651,73696,1955,904,1051
"Missaukee County","Missaukee County, Michigan","050","00","2","3","26113","26","113",12147,12029,118,89,29
"Monroe County","Monroe County, Michigan","050","00","2","3","26115","26","115",133600,131669,1931,1213,718
"Montcalm County","Montcalm County, Michigan","050","00","2","3","26117","26","117",53059,52621,438,288,150
"Montmorency County","Montmorency County, Michigan","050","00","2","3","26119","26","119",8936,8778,158,134,24
"Muskegon County","Muskegon County, Michigan","050","00","2","3","26121","26","121",158983,156993,1990,1319,671
"Newaygo County","Newaygo County, Michigan","050","00","2","3","26123","26","123",38202,37700,502,286,216
"Oakland County","Oakland County, Michigan","050","00","2","3","26125","26","125",1083592,1007435,76157,43672,32485
"Oceana County","Oceana County, Michigan","050","00","2","3","26127","26","127",22454,22063,391,248,143
"Ogemaw County","Ogemaw County, Michigan","050","00","2","3","26129","26","129",18681,18434,247,194,53
"Ontonagon County","Ontonagon County, Michigan","050","00","2","3","26131","26","131",8854,8751,103,74,29
"Osceola County","Osceola County, Michigan","050","00","2","3","26133","26","133",20146,19980,166,125,41
"Oscoda County","Oscoda County, Michigan","050","00","2","3","26135","26","135",7842,7740,102,78,24
"Otsego County","Otsego County, Michigan","050","00","2","3","26137","26","137",17957,17609,348,255,93
"Ottawa County","Ottawa County, Michigan","050","00","2","3","26139","26","139",187768,181147,6621,3250,3371
"Presque Isle County","Presque Isle County, Michigan","050","00","2","3","26141","26","141",13743,13598,145,101,44
"Roscommon County","Roscommon County, Michigan","050","00","2","3","26143","26","143",19776,19352,424,350,74
"Saginaw County","Saginaw County, Michigan","050","00","2","3","26145","26","145",211946,207963,3983,2417,1566
"St. Clair County","St. Clair County, Michigan","050","00","2","3","26147","26","147",145607,141905,3702,2195,1507
"St. Joseph County","St. Joseph County, Michigan","050","00","2","3","26149","26","149",58913,58137,776,521,255
"Sanilac County","Sanilac County, Michigan","050","00","2","3","26151","26","151",39928,39139,789,591,198
"Schoolcraft County","Schoolcraft County, Michigan","050","00","2","3","26153","26","153",8302,8202,100,75,25
"Shiawassee County","Shiawassee County, Michigan","050","00","2","3","26155","26","155",69770,68952,818,618,200
"Tuscola County","Tuscola County, Michigan","050","00","2","3","26157","26","157",55498,54872,626,462,164
"Van Buren County","Van Buren County, Michigan","050","00","2","3","26159","26","159",70060,68627,1433,717,716
"Washtenaw County","Washtenaw County, Michigan","050","00","2","3","26161","26","161",282937,263522,19415,6720,12695
"Wayne County","Wayne County, Michigan","050","00","2","3","26163","26","163",2111687,2009351,102336,56344,45992
"Wexford County","Wexford County, Michigan","050","00","2","3","26165","26","165",26360,26013,347,243,104
"Aitkin County","Aitkin County, Minnesota","050","00","2","4","27001","27","001",12425,12330,95,76,19
"Anoka County","Anoka County, Minnesota","050","00","2","4","27003","27","003",243641,239551,4090,2182,1908
"Becker County","Becker County, Minnesota","050","00","2","4","27005","27","005",27881,27592,289,214,75
"Beltrami County","Beltrami County, Minnesota","050","00","2","4","27007","27","007",34384,34005,379,173,206
"Benton County","Benton County, Minnesota","050","00","2","4","27009","27","009",30185,29988,197,114,83
"Big Stone County","Big Stone County, Minnesota","050","00","2","4","27011","27","011",6285,6230,55,41,14
"Blue Earth County","Blue Earth County, Minnesota","050","00","2","4","27013","27","013",54044,52821,1223,459,764
"Brown County","Brown County, Minnesota","050","00","2","4","27015","27","015",26984,26764,220,155,65
"Carlton County","Carlton County, Minnesota","050","00","2","4","27017","27","017",29259,28958,301,234,67
"Carver County","Carver County, Minnesota","050","00","2","4","27019","27","019",47915,47277,638,383,255
"Cass County","Cass County, Minnesota","050","00","2","4","27021","27","021",21791,21570,221,180,41
"Chippewa County","Chippewa County, Minnesota","050","00","2","4","27023","27","023",13228,13146,82,55,27
"Chisago County","Chisago County, Minnesota","050","00","2","4","27025","27","025",30521,30267,254,151,103
"Clay County","Clay County, Minnesota","050","00","2","4","27027","27","027",50422,49478,944,390,554
"Clearwater County","Clearwater County, Minnesota","050","00","2","4","27029","27","029",8309,8198,111,94,17
"Cook County","Cook County, Minnesota","050","00","2","4","27031","27","031",3868,3810,58,46,12
"Cottonwood County","Cottonwood County, Minnesota","050","00","2","4","27033","27","033",12694,12538,156,79,77
"Crow Wing County","Crow Wing County, Minnesota","050","00","2","4","27035","27","035",44249,43831,418,356,62
"Dakota County","Dakota County, Minnesota","050","00","2","4","27037","27","037",275227,268957,6270,3355,2915
"Dodge County","Dodge County, Minnesota","050","00","2","4","27039","27","039",15731,15594,137,81,56
"Douglas County","Douglas County, Minnesota","050","00","2","4","27041","27","041",28674,28479,195,148,47
"Faribault County","Faribault County, Minnesota","050","00","2","4","27043","27","043",16937,16819,118,50,68
"Fillmore County","Fillmore County, Minnesota","050","00","2","4","27045","27","045",20777,20641,136,101,35
"Freeborn County","Freeborn County, Minnesota","050","00","2","4","27047","27","047",33060,32693,367,254,113
"Goodhue County","Goodhue County, Minnesota","050","00","2","4","27049","27","049",40690,40397,293,216,77
"Grant County","Grant County, Minnesota","050","00","2","4","27051","27","051",6246,6226,20,18,2
"Hennepin County","Hennepin County, Minnesota","050","00","2","4","27053","27","053",1032431,988274,44157,18992,25165
"Houston County","Houston County, Minnesota","050","00","2","4","27055","27","055",18497,18368,129,72,57
"Hubbard County","Hubbard County, Minnesota","050","00","2","4","27057","27","057",14939,14799,140,93,47
"Isanti County","Isanti County, Minnesota","050","00","2","4","27059","27","059",25921,25668,253,183,70
"Itasca County","Itasca County, Minnesota","050","00","2","4","27061","27","061",40863,40440,423,353,70
"Jackson County","Jackson County, Minnesota","050","00","2","4","27063","27","063",11677,11495,182,67,115
"Kanabec County","Kanabec County, Minnesota","050","00","2","4","27065","27","065",12802,12647,155,106,49
"Kandiyohi County","Kandiyohi County, Minnesota","050","00","2","4","27067","27","067",38761,38327,434,308,126
"Kittson County","Kittson County, Minnesota","050","00","2","4","27069","27","069",5767,5647,120,88,32
"Koochiching County","Koochiching County, Minnesota","050","00","2","4","27071","27","071",16299,15421,878,467,411
"Lac qui Parle County","Lac qui Parle County, Minnesota","050","00","2","4","27073","27","073",8924,8868,56,47,9
"Lake County","Lake County, Minnesota","050","00","2","4","27075","27","075",10415,10258,157,136,21
"Lake of the Woods County","Lake of the Woods County, Minnesota","050","00","2","4","27077","27","077",4076,4019,57,42,15
"Le Sueur County","Le Sueur County, Minnesota","050","00","2","4","27079","27","079",23239,23139,100,77,23
"Lincoln County","Lincoln County, Minnesota","050","00","2","4","27081","27","081",6890,6835,55,46,9
"Lyon County","Lyon County, Minnesota","050","00","2","4","27083","27","083",24789,24503,286,154,132
"McLeod County","McLeod County, Minnesota","050","00","2","4","27085","27","085",32030,31697,333,203,130
"Mahnomen County","Mahnomen County, Minnesota","050","00","2","4","27087","27","087",5044,5013,31,28,3
"Marshall County","Marshall County, Minnesota","050","00","2","4","27089","27","089",10993,10890,103,60,43
"Martin County","Martin County, Minnesota","050","00","2","4","27091","27","091",22914,22754,160,123,37
"Meeker County","Meeker County, Minnesota","050","00","2","4","27093","27","093",20846,20658,188,142,46
"Mille Lacs County","Mille Lacs County, Minnesota","050","00","2","4","27095","27","095",18670,18494,176,137,39
"Morrison County","Morrison County, Minnesota","050","00","2","4","27097","27","097",29604,29459,145,96,49
"Mower County","Mower County, Minnesota","050","00","2","4","27099","27","099",37385,37035,350,164,186
"Murray County","Murray County, Minnesota","050","00","2","4","27101","27","101",9660,9597,63,53,10
"Nicollet County","Nicollet County, Minnesota","050","00","2","4","27103","27","103",28076,27806,270,127,143
"Nobles County","Nobles County, Minnesota","050","00","2","4","27105","27","105",20098,19654,444,124,320
"Norman County","Norman County, Minnesota","050","00","2","4","27107","27","107",7975,7915,60,43,17
"Olmsted County","Olmsted County, Minnesota","050","00","2","4","27109","27","109",106470,102234,4236,1608,2628
"Otter Tail County","Otter Tail County, Minnesota","050","00","2","4","27111","27","111",50714,50157,557,330,227
"Pennington County","Pennington County, Minnesota","050","00","2","4","27113","27","113",13306,13165,141,99,42
"Pine County","Pine County, Minnesota","050","00","2","4","27115","27","115",21264,20745,519,228,291
"Pipestone County","Pipestone County, Minnesota","050","00","2","4","27117","27","117",10491,10387,104,89,15
"Polk County","Polk County, Minnesota","050","00","2","4","27119","27","119",32498,32120,378,222,156
"Pope County","Pope County, Minnesota","050","00","2","4","27121","27","121",10745,10680,65,51,14
"Ramsey County","Ramsey County, Minnesota","050","00","2","4","27123","27","123",485765,458316,27449,8597,18852
"Red Lake County","Red Lake County, Minnesota","050","00","2","4","27125","27","125",4525,4489,36,29,7
"Redwood County","Redwood County, Minnesota","050","00","2","4","27127","27","127",17254,17161,93,71,22
"Renville County","Renville County, Minnesota","050","00","2","4","27129","27","129",17673,17558,115,74,41
"Rice County","Rice County, Minnesota","050","00","2","4","27131","27","131",49183,48510,673,195,478
"Rock County","Rock County, Minnesota","050","00","2","4","27133","27","133",9806,9686,120,97,23
"Roseau County","Roseau County, Minnesota","050","00","2","4","27135","27","135",15026,14757,269,143,126
"St. Louis County","St. Louis County, Minnesota","050","00","2","4","27137","27","137",198213,194380,3833,2915,918
"Scott County","Scott County, Minnesota","050","00","2","4","27139","27","139",57846,57306,540,285,255
"Sherburne County","Sherburne County, Minnesota","050","00","2","4","27141","27","141",41945,41606,339,227,112
"Sibley County","Sibley County, Minnesota","050","00","2","4","27143","27","143",14366,14262,104,69,35
"Stearns County","Stearns County, Minnesota","050","00","2","4","27145","27","145",118791,117879,912,493,419
"Steele County","Steele County, Minnesota","050","00","2","4","27147","27","147",30729,30431,298,153,145
"Stevens County","Stevens County, Minnesota","050","00","2","4","27149","27","149",10634,10463,171,61,110
"Swift County","Swift County, Minnesota","050","00","2","4","27151","27","151",10724,10666,58,43,15
"Todd County","Todd County, Minnesota","050","00","2","4","27153","27","153",23363,23223,140,108,32
"Traverse County","Traverse County, Minnesota","050","00","2","4","27155","27","155",4463,4430,33,24,9
"Wabasha County","Wabasha County, Minnesota","050","00","2","4","27157","27","157",19744,19592,152,81,71
"Wadena County","Wadena County, Minnesota","050","00","2","4","27159","27","159",13154,13022,132,93,39
"Waseca County","Waseca County, Minnesota","050","00","2","4","27161","27","161",18079,18009,70,41,29
"Washington County","Washington County, Minnesota","050","00","2","4","27163","27","163",145896,143157,2739,1528,1211
"Watonwan County","Watonwan County, Minnesota","050","00","2","4","27165","27","165",11682,11465,217,85,132
"Wilkin County","Wilkin County, Minnesota","050","00","2","4","27167","27","167",7516,7470,46,22,24
"Winona County","Winona County, Minnesota","050","00","2","4","27169","27","169",47828,47111,717,234,483
"Wright County","Wright County, Minnesota","050","00","2","4","27171","27","171",68710,68167,543,287,256
"Yellow Medicine County","Yellow Medicine County, Minnesota","050","00","2","4","27173","27","173",11684,11616,68,46,22
"Adams County","Adams County, Mississippi","050","00","3","6","28001","28","001",35356,35236,120,87,33
"Alcorn County","Alcorn County, Mississippi","050","00","3","6","28003","28","003",31722,31648,74,69,5
"Amite County","Amite County, Mississippi","050","00","3","6","28005","28","005",13328,13295,33,16,17
"Attala County","Attala County, Mississippi","050","00","3","6","28007","28","007",18481,18449,32,13,19
"Benton County","Benton County, Mississippi","050","00","3","6","28009","28","009",8046,8046,0,0,0
"Bolivar County","Bolivar County, Mississippi","050","00","3","6","28011","28","011",41875,41731,144,99,45
"Calhoun County","Calhoun County, Mississippi","050","00","3","6","28013","28","013",14908,14849,59,19,40
"Carroll County","Carroll County, Mississippi","050","00","3","6","28015","28","015",9237,9218,19,11,8
"Chickasaw County","Chickasaw County, Mississippi","050","00","3","6","28017","28","017",18085,18005,80,50,30
"Choctaw County","Choctaw County, Mississippi","050","00","3","6","28019","28","019",9071,9067,4,0,4
"Claiborne County","Claiborne County, Mississippi","050","00","3","6","28021","28","021",11370,11301,69,12,57
"Clarke County","Clarke County, Mississippi","050","00","3","6","28023","28","023",17313,17279,34,18,16
"Clay County","Clay County, Mississippi","050","00","3","6","28025","28","025",21120,21007,113,64,49
"Coahoma County","Coahoma County, Mississippi","050","00","3","6","28027","28","027",31665,31563,102,89,13
"Copiah County","Copiah County, Mississippi","050","00","3","6","28029","28","029",27592,27527,65,52,13
"Covington County","Covington County, Mississippi","050","00","3","6","28031","28","031",16527,16503,24,9,15
"DeSoto County","DeSoto County, Mississippi","050","00","3","6","28033","28","033",67910,67608,302,157,145
"Forrest County","Forrest County, Mississippi","050","00","3","6","28035","28","035",68314,67245,1069,302,767
"Franklin County","Franklin County, Mississippi","050","00","3","6","28037","28","037",8377,8369,8,6,2
"George County","George County, Mississippi","050","00","3","6","28039","28","039",16673,16603,70,38,32
"Greene County","Greene County, Mississippi","050","00","3","6","28041","28","041",10220,10180,40,11,29
"Grenada County","Grenada County, Mississippi","050","00","3","6","28043","28","043",21555,21504,51,32,19
"Hancock County","Hancock County, Mississippi","050","00","3","6","28045","28","045",31760,31224,536,350,186
"Harrison County","Harrison County, Mississippi","050","00","3","6","28047","28","047",165365,160395,4970,2161,2809
"Hinds County","Hinds County, Mississippi","050","00","3","6","28049","28","049",254441,251926,2515,1044,1471
"Holmes County","Holmes County, Mississippi","050","00","3","6","28051","28","051",21604,21535,69,51,18
"Humphreys County","Humphreys County, Mississippi","050","00","3","6","28053","28","053",12134,12092,42,18,24
"Issaquena County","Issaquena County, Mississippi","050","00","3","6","28055","28","055",1909,1906,3,0,3
"Itawamba County","Itawamba County, Mississippi","050","00","3","6","28057","28","057",20017,19987,30,21,9
"Jackson County","Jackson County, Mississippi","050","00","3","6","28059","28","059",115243,113580,1663,1023,640
"Jasper County","Jasper County, Mississippi","050","00","3","6","28061","28","061",17114,17102,12,12,0
"Jefferson County","Jefferson County, Mississippi","050","00","3","6","28063","28","063",8653,8587,66,7,59
"Jefferson Davis County","Jefferson Davis County, Mississippi","050","00","3","6","28065","28","065",14051,14023,28,22,6
"Jones County","Jones County, Mississippi","050","00","3","6","28067","28","067",62031,61788,243,155,88
"Kemper County","Kemper County, Mississippi","050","00","3","6","28069","28","069",10356,10304,52,21,31
"Lafayette County","Lafayette County, Mississippi","050","00","3","6","28071","28","071",31826,30837,989,134,855
"Lamar County","Lamar County, Mississippi","050","00","3","6","28073","28","073",30424,30231,193,101,92
"Lauderdale County","Lauderdale County, Mississippi","050","00","3","6","28075","28","075",75555,75031,524,324,200
"Lawrence County","Lawrence County, Mississippi","050","00","3","6","28077","28","077",12458,12416,42,20,22
"Leake County","Leake County, Mississippi","050","00","3","6","28079","28","079",18436,18412,24,24,0
"Lee County","Lee County, Mississippi","050","00","3","6","28081","28","081",65581,65321,260,79,181
"Leflore County","Leflore County, Mississippi","050","00","3","6","28083","28","083",37341,37172,169,115,54
"Lincoln County","Lincoln County, Mississippi","050","00","3","6","28085","28","085",30278,30181,97,63,34
"Lowndes County","Lowndes County, Mississippi","050","00","3","6","28087","28","087",59308,58770,538,334,204
"Madison County","Madison County, Mississippi","050","00","3","6","28089","28","089",53794,53452,342,160,182
"Marion County","Marion County, Mississippi","050","00","3","6","28091","28","091",25544,25418,126,77,49
"Marshall County","Marshall County, Mississippi","050","00","3","6","28093","28","093",30361,30238,123,43,80
"Monroe County","Monroe County, Mississippi","050","00","3","6","28095","28","095",36582,36452,130,58,72
"Montgomery County","Montgomery County, Mississippi","050","00","3","6","28097","28","097",12388,12377,11,3,8
"Neshoba County","Neshoba County, Mississippi","050","00","3","6","28099","28","099",24800,24764,36,26,10
"Newton County","Newton County, Mississippi","050","00","3","6","28101","28","101",20291,20262,29,17,12
"Noxubee County","Noxubee County, Mississippi","050","00","3","6","28103","28","103",12604,12594,10,0,10
"Oktibbeha County","Oktibbeha County, Mississippi","050","00","3","6","28105","28","105",38375,37220,1155,178,977
"Panola County","Panola County, Mississippi","050","00","3","6","28107","28","107",29996,29944,52,44,8
"Pearl River County","Pearl River County, Mississippi","050","00","3","6","28109","28","109",38714,38431,283,146,137
"Perry County","Perry County, Mississippi","050","00","3","6","28111","28","111",10865,10840,25,7,18
"Pike County","Pike County, Mississippi","050","00","3","6","28113","28","113",36882,36753,129,90,39
"Pontotoc County","Pontotoc County, Mississippi","050","00","3","6","28115","28","115",22237,22182,55,50,5
"Prentiss County","Prentiss County, Mississippi","050","00","3","6","28117","28","117",23278,23223,55,37,18
"Quitman County","Quitman County, Mississippi","050","00","3","6","28119","28","119",10490,10456,34,18,16
"Rankin County","Rankin County, Mississippi","050","00","3","6","28121","28","121",87161,86583,578,420,158
"Scott County","Scott County, Mississippi","050","00","3","6","28123","28","123",24137,24040,97,71,26
"Sharkey County","Sharkey County, Mississippi","050","00","3","6","28125","28","125",7066,7060,6,2,4
"Simpson County","Simpson County, Mississippi","050","00","3","6","28127","28","127",23953,23918,35,26,9
"Smith County","Smith County, Mississippi","050","00","3","6","28129","28","129",14798,14770,28,8,20
"Stone County","Stone County, Mississippi","050","00","3","6","28131","28","131",10750,10656,94,0,94
"Sunflower County","Sunflower County, Mississippi","050","00","3","6","28133","28","133",32867,32788,79,79,0
"Tallahatchie County","Tallahatchie County, Mississippi","050","00","3","6","28135","28","135",15210,15181,29,24,5
"Tate County","Tate County, Mississippi","050","00","3","6","28137","28","137",21432,21390,42,26,16
"Tippah County","Tippah County, Mississippi","050","00","3","6","28139","28","139",19523,19493,30,6,24
"Tishomingo County","Tishomingo County, Mississippi","050","00","3","6","28141","28","141",17683,17628,55,33,22
"Tunica County","Tunica County, Mississippi","050","00","3","6","28143","28","143",8164,8162,2,2,0
"Union County","Union County, Mississippi","050","00","3","6","28145","28","145",22085,22040,45,20,25
"Walthall County","Walthall County, Mississippi","050","00","3","6","28147","28","147",14352,14298,54,43,11
"Warren County","Warren County, Mississippi","050","00","3","6","28149","28","149",47880,47479,401,182,219
"Washington County","Washington County, Mississippi","050","00","3","6","28151","28","151",67935,67575,360,224,136
"Wayne County","Wayne County, Mississippi","050","00","3","6","28153","28","153",19517,19434,83,32,51
"Webster County","Webster County, Mississippi","050","00","3","6","28155","28","155",10222,10192,30,16,14
"Wilkinson County","Wilkinson County, Mississippi","050","00","3","6","28157","28","157",9678,9670,8,8,0
"Winston County","Winston County, Mississippi","050","00","3","6","28159","28","159",19433,19348,85,63,22
"Yalobusha County","Yalobusha County, Mississippi","050","00","3","6","28161","28","161",12033,12010,23,23,0
"Yazoo County","Yazoo County, Mississippi","050","00","3","6","28163","28","163",25506,25459,47,19,28
"Adair County","Adair County, Missouri","050","00","2","4","29001","29","001",24577,24196,381,156,225
"Andrew County","Andrew County, Missouri","050","00","2","4","29003","29","003",14632,14620,12,6,6
"Atchison County","Atchison County, Missouri","050","00","2","4","29005","29","005",7457,7434,23,4,19
"Audrain County","Audrain County, Missouri","050","00","2","4","29007","29","007",23599,23457,142,62,80
"Barry County","Barry County, Missouri","050","00","2","4","29009","29","009",27547,27411,136,65,71
"Barton County","Barton County, Missouri","050","00","2","4","29011","29","011",11312,11284,28,26,2
"Bates County","Bates County, Missouri","050","00","2","4","29013","29","013",15025,14999,26,20,6
"Benton County","Benton County, Missouri","050","00","2","4","29015","29","015",13859,13821,38,33,5
"Bollinger County","Bollinger County, Missouri","050","00","2","4","29017","29","017",10619,10591,28,16,12
"Boone County","Boone County, Missouri","050","00","2","4","29019","29","019",112379,107754,4625,1166,3459
"Buchanan County","Buchanan County, Missouri","050","00","2","4","29021","29","021",83083,82447,636,474,162
"Butler County","Butler County, Missouri","050","00","2","4","29023","29","023",38765,38500,265,181,84
"Caldwell County","Caldwell County, Missouri","050","00","2","4","29025","29","025",8380,8365,15,11,4
"Callaway County","Callaway County, Missouri","050","00","2","4","29027","29","027",32809,32536,273,175,98
"Camden County","Camden County, Missouri","050","00","2","4","29029","29","029",27495,27174,321,221,100
"Cape Girardeau County","Cape Girardeau County, Missouri","050","00","2","4","29031","29","031",61633,60961,672,248,424
"Carroll County","Carroll County, Missouri","050","00","2","4","29033","29","033",10748,10711,37,34,3
"Carter County","Carter County, Missouri","050","00","2","4","29035","29","035",5515,5503,12,7,5
"Cass County","Cass County, Missouri","050","00","2","4","29037","29","037",63808,63147,661,452,209
"Cedar County","Cedar County, Missouri","050","00","2","4","29039","29","039",12093,12048,45,23,22
"Chariton County","Chariton County, Missouri","050","00","2","4","29041","29","041",9202,9177,25,19,6
"Christian County","Christian County, Missouri","050","00","2","4","29043","29","043",32644,32451,193,93,100
"Clark County","Clark County, Missouri","050","00","2","4","29045","29","045",7547,7523,24,19,5
"Clay County","Clay County, Missouri","050","00","2","4","29047","29","047",153411,150688,2723,1638,1085
"Clinton County","Clinton County, Missouri","050","00","2","4","29049","29","049",16595,16505,90,73,17
"Cole County","Cole County, Missouri","050","00","2","4","29051","29","051",63579,62913,666,398,268
"Cooper County","Cooper County, Missouri","050","00","2","4","29053","29","053",14835,14739,96,64,32
"Crawford County","Crawford County, Missouri","050","00","2","4","29055","29","055",19173,19086,87,71,16
"Dade County","Dade County, Missouri","050","00","2","4","29057","29","057",7449,7396,53,44,9
"Dallas County","Dallas County, Missouri","050","00","2","4","29059","29","059",12646,12554,92,51,41
"Daviess County","Daviess County, Missouri","050","00","2","4","29061","29","061",7865,7841,24,10,14
"DeKalb County","DeKalb County, Missouri","050","00","2","4","29063","29","063",9967,9904,63,41,22
"Dent County","Dent County, Missouri","050","00","2","4","29065","29","065",13702,13603,99,75,24
"Douglas County","Douglas County, Missouri","050","00","2","4","29067","29","067",11876,11828,48,31,17
"Dunklin County","Dunklin County, Missouri","050","00","2","4","29069","29","069",33112,33022,90,63,27
"Franklin County","Franklin County, Missouri","050","00","2","4","29071","29","071",80603,79973,630,304,326
"Gasconade County","Gasconade County, Missouri","050","00","2","4","29073","29","073",14006,13903,103,68,35
"Gentry County","Gentry County, Missouri","050","00","2","4","29075","29","075",6848,6827,21,17,4
"Greene County","Greene County, Missouri","050","00","2","4","29077","29","077",207949,205361,2588,1359,1229
"Grundy County","Grundy County, Missouri","050","00","2","4","29079","29","079",10536,10494,42,13,29
"Harrison County","Harrison County, Missouri","050","00","2","4","29081","29","081",8469,8450,19,19,0
"Henry County","Henry County, Missouri","050","00","2","4","29083","29","083",20044,19968,76,65,11
"Hickory County","Hickory County, Missouri","050","00","2","4","29085","29","085",7335,7301,34,27,7
"Holt County","Holt County, Missouri","050","00","2","4","29087","29","087",6034,6017,17,10,7
"Howard County","Howard County, Missouri","050","00","2","4","29089","29","089",9631,9588,43,13,30
"Howell County","Howell County, Missouri","050","00","2","4","29091","29","091",31447,31270,177,115,62
"Iron County","Iron County, Missouri","050","00","2","4","29093","29","093",10726,10678,48,30,18
"Jackson County","Jackson County, Missouri","050","00","2","4","29095","29","095",633232,618901,14331,7515,6816
"Jasper County","Jasper County, Missouri","050","00","2","4","29097","29","097",90465,89542,923,454,469
"Jefferson County","Jefferson County, Missouri","050","00","2","4","29099","29","099",171380,170000,1380,900,480
"Johnson County","Johnson County, Missouri","050","00","2","4","29101","29","101",42514,41636,878,397,481
"Knox County","Knox County, Missouri","050","00","2","4","29103","29","103",4482,4460,22,22,0
"Laclede County","Laclede County, Missouri","050","00","2","4","29105","29","105",27158,26963,195,119,76
"Lafayette County","Lafayette County, Missouri","050","00","2","4","29107","29","107",31107,30880,227,130,97
"Lawrence County","Lawrence County, Missouri","050","00","2","4","29109","29","109",30236,30117,119,84,35
"Lewis County","Lewis County, Missouri","050","00","2","4","29111","29","111",10233,10195,38,23,15
"Lincoln County","Lincoln County, Missouri","050","00","2","4","29113","29","113",28892,28729,163,104,59
"Linn County","Linn County, Missouri","050","00","2","4","29115","29","115",13885,13829,56,22,34
"Livingston County","Livingston County, Missouri","050","00","2","4","29117","29","117",14592,14514,78,52,26
"McDonald County","McDonald County, Missouri","050","00","2","4","29119","29","119",16938,16843,95,65,30
"Macon County","Macon County, Missouri","050","00","2","4","29121","29","121",15345,15322,23,18,5
"Madison County","Madison County, Missouri","050","00","2","4","29123","29","123",11127,11081,46,14,32
"Maries County","Maries County, Missouri","050","00","2","4","29125","29","125",7976,7927,49,23,26
"Marion County","Marion County, Missouri","050","00","2","4","29127","29","127",27682,27481,201,107,94
"Mercer County","Mercer County, Missouri","050","00","2","4","29129","29","129",3723,3716,7,7,0
"Miller County","Miller County, Missouri","050","00","2","4","29131","29","131",20700,20594,106,97,9
"Mississippi County","Mississippi County, Missouri","050","00","2","4","29133","29","133",14442,14410,32,21,11
"Moniteau County","Moniteau County, Missouri","050","00","2","4","29135","29","135",12298,12268,30,19,11
"Monroe County","Monroe County, Missouri","050","00","2","4","29137","29","137",9104,9090,14,7,7
"Montgomery County","Montgomery County, Missouri","050","00","2","4","29139","29","139",11355,11312,43,30,13
"Morgan County","Morgan County, Missouri","050","00","2","4","29141","29","141",15574,15477,97,64,33
"New Madrid County","New Madrid County, Missouri","050","00","2","4","29143","29","143",20928,20885,43,17,26
"Newton County","Newton County, Missouri","050","00","2","4","29145","29","145",44445,44134,311,204,107
"Nodaway County","Nodaway County, Missouri","050","00","2","4","29147","29","147",21709,21494,215,67,148
"Oregon County","Oregon County, Missouri","050","00","2","4","29149","29","149",9470,9448,22,13,9
"Osage County","Osage County, Missouri","050","00","2","4","29151","29","151",12018,11982,36,26,10
"Ozark County","Ozark County, Missouri","050","00","2","4","29153","29","153",8598,8555,43,32,11
"Pemiscot County","Pemiscot County, Missouri","050","00","2","4","29155","29","155",21921,21857,64,29,35
"Perry County","Perry County, Missouri","050","00","2","4","29157","29","157",16648,16532,116,74,42
"Pettis County","Pettis County, Missouri","050","00","2","4","29159","29","159",35437,35172,265,128,137
"Phelps County","Phelps County, Missouri","050","00","2","4","29161","29","161",35248,34167,1081,385,696
"Pike County","Pike County, Missouri","050","00","2","4","29163","29","163",15969,15887,82,49,33
"Platte County","Platte County, Missouri","050","00","2","4","29165","29","165",57867,56456,1411,727,684
"Polk County","Polk County, Missouri","050","00","2","4","29167","29","167",21826,21692,134,66,68
"Pulaski County","Pulaski County, Missouri","050","00","2","4","29169","29","169",41307,39368,1939,1081,858
"Putnam County","Putnam County, Missouri","050","00","2","4","29171","29","171",5079,5069,10,7,3
"Ralls County","Ralls County, Missouri","050","00","2","4","29173","29","173",8476,8472,4,4,0
"Randolph County","Randolph County, Missouri","050","00","2","4","29175","29","175",24370,24218,152,85,67
"Ray County","Ray County, Missouri","050","00","2","4","29177","29","177",21971,21888,83,73,10
"Reynolds County","Reynolds County, Missouri","050","00","2","4","29179","29","179",6661,6661,0,0,0
"Ripley County","Ripley County, Missouri","050","00","2","4","29181","29","181",12303,12241,62,41,21
"St. Charles County","St. Charles County, Missouri","050","00","2","4","29183","29","183",212907,210373,2534,1573,961
"St. Clair County","St. Clair County, Missouri","050","00","2","4","29185","29","185",8457,8413,44,29,15
"Ste. Genevieve County","Ste. Genevieve County, Missouri","050","00","2","4","29186","29","186",16037,15993,44,33,11
"St. Francois County","St. Francois County, Missouri","050","00","2","4","29187","29","187",48904,48691,213,143,70
"St. Louis County","St. Louis County, Missouri","050","00","2","4","29189","29","189",993529,966067,27462,16576,10886
"Saline County","Saline County, Missouri","050","00","2","4","29195","29","195",23523,23457,66,35,31
"Schuyler County","Schuyler County, Missouri","050","00","2","4","29197","29","197",4236,4232,4,2,2
"Scotland County","Scotland County, Missouri","050","00","2","4","29199","29","199",4822,4815,7,5,2
"Scott County","Scott County, Missouri","050","00","2","4","29201","29","201",39376,39281,95,49,46
"Shannon County","Shannon County, Missouri","050","00","2","4","29203","29","203",7613,7579,34,27,7
"Shelby County","Shelby County, Missouri","050","00","2","4","29205","29","205",6942,6927,15,11,4
"Stoddard County","Stoddard County, Missouri","050","00","2","4","29207","29","207",28895,28827,68,38,30
"Stone County","Stone County, Missouri","050","00","2","4","29209","29","209",19078,18893,185,106,79
"Sullivan County","Sullivan County, Missouri","050","00","2","4","29211","29","211",6326,6299,27,19,8
"Taney County","Taney County, Missouri","050","00","2","4","29213","29","213",25561,25377,184,118,66
"Texas County","Texas County, Missouri","050","00","2","4","29215","29","215",21476,21250,226,126,100
"Vernon County","Vernon County, Missouri","050","00","2","4","29217","29","217",19041,18813,228,55,173
"Warren County","Warren County, Missouri","050","00","2","4","29219","29","219",19534,19441,93,61,32
"Washington County","Washington County, Missouri","050","00","2","4","29221","29","221",20380,20275,105,94,11
"Wayne County","Wayne County, Missouri","050","00","2","4","29223","29","223",11543,11529,14,5,9
"Webster County","Webster County, Missouri","050","00","2","4","29225","29","225",23753,23671,82,53,29
"Worth County","Worth County, Missouri","050","00","2","4","29227","29","227",2440,2422,18,9,9
"Wright County","Wright County, Missouri","050","00","2","4","29229","29","229",16758,16680,78,55,23
"St. Louis city","St. Louis city, Missouri","050","00","2","4","29510","29","510",396685,386651,10034,4949,5085
"Beaverhead County","Beaverhead County, Montana","050","00","4","8","30001","30","001",8424,8249,175,85,90
"Big Horn County","Big Horn County, Montana","050","00","4","8","30003","30","003",11337,11302,35,17,18
"Blaine County","Blaine County, Montana","050","00","4","8","30005","30","005",6728,6657,71,59,12
"Broadwater County","Broadwater County, Montana","050","00","4","8","30007","30","007",3318,3294,24,18,6
"Carbon County","Carbon County, Montana","050","00","4","8","30009","30","009",8080,7977,103,92,11
"Carter County","Carter County, Montana","050","00","4","8","30011","30","011",1503,1496,7,5,2
"Cascade County","Cascade County, Montana","050","00","4","8","30013","30","013",77691,75550,2141,1417,724
"Chouteau County","Chouteau County, Montana","050","00","4","8","30015","30","015",5452,5354,98,43,55
"Custer County","Custer County, Montana","050","00","4","8","30017","30","017",11697,11511,186,144,42
"Daniels County","Daniels County, Montana","050","00","4","8","30019","30","019",2266,2127,139,120,19
"Dawson County","Dawson County, Montana","050","00","4","8","30021","30","021",9505,9445,60,54,6
"Deer Lodge County","Deer Lodge County, Montana","050","00","4","8","30023","30","023",10278,10097,181,142,39
"Fallon County","Fallon County, Montana","050","00","4","8","30025","30","025",3103,3060,43,23,20
"Fergus County","Fergus County, Montana","050","00","4","8","30027","30","027",12083,11930,153,108,45
"Flathead County","Flathead County, Montana","050","00","4","8","30029","30","029",59218,58305,913,592,321
"Gallatin County","Gallatin County, Montana","050","00","4","8","30031","30","031",50463,49359,1104,446,658
"Garfield County","Garfield County, Montana","050","00","4","8","30033","30","033",1589,1582,7,5,2
"Glacier County","Glacier County, Montana","050","00","4","8","30035","30","035",12121,11932,189,131,58
"Golden Valley County","Golden Valley County, Montana","050","00","4","8","30037","30","037",912,896,16,11,5
"Granite County","Granite County, Montana","050","00","4","8","30039","30","039",2548,2533,15,7,8
"Hill County","Hill County, Montana","050","00","4","8","30041","30","041",17654,17311,343,291,52
"Jefferson County","Jefferson County, Montana","050","00","4","8","30043","30","043",7939,7825,114,85,29
"Judith Basin County","Judith Basin County, Montana","050","00","4","8","30045","30","045",2282,2244,38,34,4
"Lake County","Lake County, Montana","050","00","4","8","30047","30","047",21041,20823,218,141,77
"Lewis and Clark County","Lewis and Clark County, Montana","050","00","4","8","30049","30","049",47495,47018,477,306,171
"Liberty County","Liberty County, Montana","050","00","4","8","30051","30","051",2295,2250,45,29,16
"Lincoln County","Lincoln County, Montana","050","00","4","8","30053","30","053",17481,17235,246,173,73
"McCone County","McCone County, Montana","050","00","4","8","30055","30","055",2276,2259,17,9,8
"Madison County","Madison County, Montana","050","00","4","8","30057","30","057",5989,5940,49,34,15
"Meagher County","Meagher County, Montana","050","00","4","8","30059","30","059",1819,1802,17,14,3
"Mineral County","Mineral County, Montana","050","00","4","8","30061","30","061",3315,3289,26,20,6
"Missoula County","Missoula County, Montana","050","00","4","8","30063","30","063",78687,76985,1702,859,843
"Musselshell County","Musselshell County, Montana","050","00","4","8","30065","30","065",4106,4025,81,68,13
"Park County","Park County, Montana","050","00","4","8","30067","30","067",14562,14031,531,196,335
"Petroleum County","Petroleum County, Montana","050","00","4","8","30069","30","069",519,515,4,2,2
"Phillips County","Phillips County, Montana","050","00","4","8","30071","30","071",5163,5062,101,62,39
"Pondera County","Pondera County, Montana","050","00","4","8","30073","30","073",6433,6264,169,150,19
"Powder River County","Powder River County, Montana","050","00","4","8","30075","30","075",2090,2077,13,11,2
"Powell County","Powell County, Montana","050","00","4","8","30077","30","077",6620,6550,70,63,7
"Prairie County","Prairie County, Montana","050","00","4","8","30079","30","079",1383,1350,33,30,3
"Ravalli County","Ravalli County, Montana","050","00","4","8","30081","30","081",25010,24652,358,178,180
"Richland County","Richland County, Montana","050","00","4","8","30083","30","083",10716,10557,159,99,60
"Roosevelt County","Roosevelt County, Montana","050","00","4","8","30085","30","085",10999,10888,111,57,54
"Rosebud County","Rosebud County, Montana","050","00","4","8","30087","30","087",10505,10438,67,56,11
"Sanders County","Sanders County, Montana","050","00","4","8","30089","30","089",8669,8550,119,89,30
"Sheridan County","Sheridan County, Montana","050","00","4","8","30091","30","091",4732,4596,136,106,30
"Silver Bow County","Silver Bow County, Montana","050","00","4","8","30093","30","093",33941,33342,599,396,203
"Stillwater County","Stillwater County, Montana","050","00","4","8","30095","30","095",6536,6494,42,38,4
"Sweet Grass County","Sweet Grass County, Montana","050","00","4","8","30097","30","097",3154,3109,45,41,4
"Teton County","Teton County, Montana","050","00","4","8","30099","30","099",6271,6176,95,80,15
"Toole County","Toole County, Montana","050","00","4","8","30101","30","101",5046,4856,190,160,30
"Treasure County","Treasure County, Montana","050","00","4","8","30103","30","103",874,860,14,11,3
"Valley County","Valley County, Montana","050","00","4","8","30105","30","105",8239,8078,161,115,46
"Wheatland County","Wheatland County, Montana","050","00","4","8","30107","30","107",2246,2222,24,13,11
"Wibaux County","Wibaux County, Montana","050","00","4","8","30109","30","109",1191,1175,16,10,6
"Yellowstone County","Yellowstone County, Montana","050","00","4","8","30111","30","111",113419,111730,1689,1076,613
"Yellowstone National Park","Yellowstone National Park, Montana","050","00","4","8","30113","30","113",52,52,0,0,0
"Adams County","Adams County, Nebraska","050","00","2","4","31001","31","001",29625,29407,218,157,61
"Antelope County","Antelope County, Nebraska","050","00","2","4","31003","31","003",7965,7939,26,22,4
"Arthur County","Arthur County, Nebraska","050","00","2","4","31005","31","005",462,458,4,4,0
"Banner County","Banner County, Nebraska","050","00","2","4","31007","31","007",852,843,9,5,4
"Blaine County","Blaine County, Nebraska","050","00","2","4","31009","31","009",675,673,2,0,2
"Boone County","Boone County, Nebraska","050","00","2","4","31011","31","011",6667,6629,38,26,12
"Box Butte County","Box Butte County, Nebraska","050","00","2","4","31013","31","013",13130,12928,202,103,99
"Boyd County","Boyd County, Nebraska","050","00","2","4","31015","31","015",2835,2824,11,7,4
"Brown County","Brown County, Nebraska","050","00","2","4","31017","31","017",3657,3644,13,6,7
"Buffalo County","Buffalo County, Nebraska","050","00","2","4","31019","31","019",37447,36946,501,199,302
"Burt County","Burt County, Nebraska","050","00","2","4","31021","31","021",7868,7813,55,27,28
"Butler County","Butler County, Nebraska","050","00","2","4","31023","31","023",8601,8577,24,20,4
"Cass County","Cass County, Nebraska","050","00","2","4","31025","31","025",21318,21058,260,136,124
"Cedar County","Cedar County, Nebraska","050","00","2","4","31027","31","027",10131,10094,37,28,9
"Chase County","Chase County, Nebraska","050","00","2","4","31029","31","029",4381,4334,47,26,21
"Cherry County","Cherry County, Nebraska","050","00","2","4","31031","31","031",6307,6278,29,29,0
"Cheyenne County","Cheyenne County, Nebraska","050","00","2","4","31033","31","033",9494,9437,57,48,9
"Clay County","Clay County, Nebraska","050","00","2","4","31035","31","035",7123,7071,52,42,10
"Colfax County","Colfax County, Nebraska","050","00","2","4","31037","31","037",9139,8880,259,146,113
"Cuming County","Cuming County, Nebraska","050","00","2","4","31039","31","039",10117,10067,50,40,10
"Custer County","Custer County, Nebraska","050","00","2","4","31041","31","041",12270,12204,66,40,26
"Dakota County","Dakota County, Nebraska","050","00","2","4","31043","31","043",16742,15855,887,273,614
"Dawes County","Dawes County, Nebraska","050","00","2","4","31045","31","045",9021,8936,85,46,39
"Dawson County","Dawson County, Nebraska","050","00","2","4","31047","31","047",19940,19802,138,101,37
"Deuel County","Deuel County, Nebraska","050","00","2","4","31049","31","049",2237,2200,37,16,21
"Dixon County","Dixon County, Nebraska","050","00","2","4","31051","31","051",6143,6127,16,14,2
"Dodge County","Dodge County, Nebraska","050","00","2","4","31053","31","053",34500,34172,328,208,120
"Douglas County","Douglas County, Nebraska","050","00","2","4","31055","31","055",416444,405726,10718,6230,4488
"Dundy County","Dundy County, Nebraska","050","00","2","4","31057","31","057",2582,2556,26,17,9
"Fillmore County","Fillmore County, Nebraska","050","00","2","4","31059","31","059",7103,7065,38,27,11
"Franklin County","Franklin County, Nebraska","050","00","2","4","31061","31","061",3938,3915,23,14,9
"Frontier County","Frontier County, Nebraska","050","00","2","4","31063","31","063",3101,3083,18,12,6
"Furnas County","Furnas County, Nebraska","050","00","2","4","31065","31","065",5553,5542,11,9,2
"Gage County","Gage County, Nebraska","050","00","2","4","31067","31","067",22794,22602,192,103,89
"Garden County","Garden County, Nebraska","050","00","2","4","31069","31","069",2460,2442,18,5,13
"Garfield County","Garfield County, Nebraska","050","00","2","4","31071","31","071",2141,2139,2,2,0
"Gosper County","Gosper County, Nebraska","050","00","2","4","31073","31","073",1928,1911,17,15,2
"Grant County","Grant County, Nebraska","050","00","2","4","31075","31","075",769,764,5,5,0
"Greeley County","Greeley County, Nebraska","050","00","2","4","31077","31","077",3006,2994,12,8,4
"Hall County","Hall County, Nebraska","050","00","2","4","31079","31","079",48925,47930,995,348,647
"Hamilton County","Hamilton County, Nebraska","050","00","2","4","31081","31","081",8862,8740,122,61,61
"Harlan County","Harlan County, Nebraska","050","00","2","4","31083","31","083",3810,3798,12,12,0
"Hayes County","Hayes County, Nebraska","050","00","2","4","31085","31","085",1222,1218,4,4,0
"Hitchcock County","Hitchcock County, Nebraska","050","00","2","4","31087","31","087",3750,3709,41,38,3
"Holt County","Holt County, Nebraska","050","00","2","4","31089","31","089",12599,12574,25,21,4
"Hooker County","Hooker County, Nebraska","050","00","2","4","31091","31","091",793,791,2,2,0
"Howard County","Howard County, Nebraska","050","00","2","4","31093","31","093",6055,6032,23,15,8
"Jefferson County","Jefferson County, Nebraska","050","00","2","4","31095","31","095",8759,8715,44,17,27
"Johnson County","Johnson County, Nebraska","050","00","2","4","31097","31","097",4673,4576,97,50,47
"Kearney County","Kearney County, Nebraska","050","00","2","4","31099","31","099",6629,6581,48,48,0
"Keith County","Keith County, Nebraska","050","00","2","4","31101","31","101",8584,8480,104,29,75
"Keya Paha County","Keya Paha County, Nebraska","050","00","2","4","31103","31","103",1029,1027,2,2,0
"Kimball County","Kimball County, Nebraska","050","00","2","4","31105","31","105",4108,4072,36,20,16
"Knox County","Knox County, Nebraska","050","00","2","4","31107","31","107",9534,9486,48,41,7
"Lancaster County","Lancaster County, Nebraska","050","00","2","4","31109","31","109",213641,208299,5342,2307,3035
"Lincoln County","Lincoln County, Nebraska","050","00","2","4","31111","31","111",32508,32193,315,232,83
"Logan County","Logan County, Nebraska","050","00","2","4","31113","31","113",878,876,2,2,0
"Loup County","Loup County, Nebraska","050","00","2","4","31115","31","115",683,683,0,0,0
"McPherson County","McPherson County, Nebraska","050","00","2","4","31117","31","117",546,546,0,0,0
"Madison County","Madison County, Nebraska","050","00","2","4","31119","31","119",32655,32286,369,161,208
"Merrick County","Merrick County, Nebraska","050","00","2","4","31121","31","121",8042,8006,36,30,6
"Morrill County","Morrill County, Nebraska","050","00","2","4","31123","31","123",5423,5273,150,100,50
"Nance County","Nance County, Nebraska","050","00","2","4","31125","31","125",4275,4245,30,28,2
"Nemaha County","Nemaha County, Nebraska","050","00","2","4","31127","31","127",7980,7934,46,35,11
"Nuckolls County","Nuckolls County, Nebraska","050","00","2","4","31129","31","129",5786,5764,22,22,0
"Otoe County","Otoe County, Nebraska","050","00","2","4","31131","31","131",14252,14216,36,27,9
"Pawnee County","Pawnee County, Nebraska","050","00","2","4","31133","31","133",3317,3271,46,37,9
"Perkins County","Perkins County, Nebraska","050","00","2","4","31135","31","135",3367,3345,22,16,6
"Phelps County","Phelps County, Nebraska","050","00","2","4","31137","31","137",9715,9678,37,25,12
"Pierce County","Pierce County, Nebraska","050","00","2","4","31139","31","139",7827,7805,22,12,10
"Platte County","Platte County, Nebraska","050","00","2","4","31141","31","141",29820,29546,274,158,116
"Polk County","Polk County, Nebraska","050","00","2","4","31143","31","143",5675,5644,31,23,8
"Red Willow County","Red Willow County, Nebraska","050","00","2","4","31145","31","145",11705,11629,76,40,36
"Richardson County","Richardson County, Nebraska","050","00","2","4","31147","31","147",9937,9874,63,44,19
"Rock County","Rock County, Nebraska","050","00","2","4","31149","31","149",2019,2015,4,4,0
"Saline County","Saline County, Nebraska","050","00","2","4","31151","31","151",12715,12589,126,67,59
"Sarpy County","Sarpy County, Nebraska","050","00","2","4","31153","31","153",102583,99533,3050,1750,1300
"Saunders County","Saunders County, Nebraska","050","00","2","4","31155","31","155",18285,18195,90,67,23
"Scotts Bluff County","Scotts Bluff County, Nebraska","050","00","2","4","31157","31","157",36025,34967,1058,666,392
"Seward County","Seward County, Nebraska","050","00","2","4","31159","31","159",15450,15329,121,58,63
"Sheridan County","Sheridan County, Nebraska","050","00","2","4","31161","31","161",6750,6701,49,31,18
"Sherman County","Sherman County, Nebraska","050","00","2","4","31163","31","163",3718,3691,27,20,7
"Sioux County","Sioux County, Nebraska","050","00","2","4","31165","31","165",1549,1517,32,14,18
"Stanton County","Stanton County, Nebraska","050","00","2","4","31167","31","167",6244,6211,33,26,7
"Thayer County","Thayer County, Nebraska","050","00","2","4","31169","31","169",6635,6576,59,28,31
"Thomas County","Thomas County, Nebraska","050","00","2","4","31171","31","171",851,842,9,6,3
"Thurston County","Thurston County, Nebraska","050","00","2","4","31173","31","173",6936,6895,41,33,8
"Valley County","Valley County, Nebraska","050","00","2","4","31175","31","175",5169,5133,36,25,11
"Washington County","Washington County, Nebraska","050","00","2","4","31177","31","177",16607,16471,136,95,41
"Wayne County","Wayne County, Nebraska","050","00","2","4","31179","31","179",9364,9244,120,92,28
"Webster County","Webster County, Nebraska","050","00","2","4","31181","31","181",4279,4270,9,7,2
"Wheeler County","Wheeler County, Nebraska","050","00","2","4","31183","31","183",948,946,2,2,0
"York County","York County, Nebraska","050","00","2","4","31185","31","185",14428,14285,143,98,45
"Churchill County","Churchill County, Nevada","050","00","4","8","32001","32","001",17938,17160,778,392,386
"Clark County","Clark County, Nevada","050","00","4","8","32003","32","003",741459,671126,70333,28696,41637
"Douglas County","Douglas County, Nevada","050","00","4","8","32005","32","005",27637,26243,1394,676,718
"Elko County","Elko County, Nevada","050","00","4","8","32007","32","007",33530,31548,1982,882,1100
"Esmeralda County","Esmeralda County, Nevada","050","00","4","8","32009","32","009",1344,1273,71,18,53
"Eureka County","Eureka County, Nevada","050","00","4","8","32011","32","011",1547,1465,82,25,57
"Humboldt County","Humboldt County, Nevada","050","00","4","8","32013","32","013",12844,11523,1321,436,885
"Lander County","Lander County, Nevada","050","00","4","8","32015","32","015",6266,5891,375,228,147
"Lincoln County","Lincoln County, Nevada","050","00","4","8","32017","32","017",3775,3665,110,65,45
"Lyon County","Lyon County, Nevada","050","00","4","8","32019","32","019",20001,18964,1037,473,564
"Mineral County","Mineral County, Nevada","050","00","4","8","32021","32","021",6475,6335,140,101,39
"Nye County","Nye County, Nevada","050","00","4","8","32023","32","023",17781,17199,582,265,317
"Pershing County","Pershing County, Nevada","050","00","4","8","32027","32","027",4336,4040,296,79,217
"Storey County","Storey County, Nevada","050","00","4","8","32029","32","029",2526,2457,69,29,40
"Washoe County","Washoe County, Nevada","050","00","4","8","32031","32","031",254667,231303,23364,9819,13545
"White Pine County","White Pine County, Nevada","050","00","4","8","32033","32","033",9264,9039,225,122,103
"Carson City","Carson City, Nevada","050","00","4","8","32510","32","510",40443,37774,2669,1067,1602
"Belknap County","Belknap County, New Hampshire","050","00","1","1","33001","33","001",49216,48051,1165,780,385
"Carroll County","Carroll County, New Hampshire","050","00","1","1","33003","33","003",35410,34591,819,543,276
"Cheshire County","Cheshire County, New Hampshire","050","00","1","1","33005","33","005",70121,68501,1620,951,669
"Coos County","Coos County, New Hampshire","050","00","1","1","33007","33","007",34828,33046,1782,1206,576
"Grafton County","Grafton County, New Hampshire","050","00","1","1","33009","33","009",74929,72572,2357,1329,1028
"Hillsborough County","Hillsborough County, New Hampshire","050","00","1","1","33011","33","011",336073,318272,17801,8981,8820
"Merrimack County","Merrimack County, New Hampshire","050","00","1","1","33013","33","013",120005,116998,3007,1689,1318
"Rockingham County","Rockingham County, New Hampshire","050","00","1","1","33015","33","015",245845,237544,8301,4721,3580
"Strafford County","Strafford County, New Hampshire","050","00","1","1","33017","33","017",104233,101053,3180,1955,1225
"Sullivan County","Sullivan County, New Hampshire","050","00","1","1","33019","33","019",38592,37431,1161,721,440
"Atlantic County","Atlantic County, New Jersey","050","00","1","2","34001","34","001",224327,211382,12945,7522,5423
"Bergen County","Bergen County, New Jersey","050","00","1","2","34003","34","003",825380,676519,148861,76393,72468
"Burlington County","Burlington County, New Jersey","050","00","1","2","34005","34","005",395066,376135,18931,11420,7511
"Camden County","Camden County, New Jersey","050","00","1","2","34007","34","007",502824,480293,22531,12817,9714
"Cape May County","Cape May County, New Jersey","050","00","1","2","34009","34","009",95089,92657,2432,1638,794
"Cumberland County","Cumberland County, New Jersey","050","00","1","2","34011","34","011",138053,131998,6055,4037,2018
"Essex County","Essex County, New Jersey","050","00","1","2","34013","34","013",778206,656870,121336,50067,71269
"Gloucester County","Gloucester County, New Jersey","050","00","1","2","34015","34","015",230082,223461,6621,4412,2209
"Hudson County","Hudson County, New Jersey","050","00","1","2","34017","34","017",553099,383665,169434,68714,100720
"Hunterdon County","Hunterdon County, New Jersey","050","00","1","2","34019","34","019",107776,102402,5374,3361,2013
"Mercer County","Mercer County, New Jersey","050","00","1","2","34021","34","021",325824,297434,28390,13997,14393
"Middlesex County","Middlesex County, New Jersey","050","00","1","2","34023","34","023",671780,576676,95104,46078,49026
"Monmouth County","Monmouth County, New Jersey","050","00","1","2","34025","34","025",553124,511416,41708,25549,16159
"Morris County","Morris County, New Jersey","050","00","1","2","34027","34","027",421353,376888,44465,23215,21250
"Ocean County","Ocean County, New Jersey","050","00","1","2","34029","34","029",433203,407013,26190,20019,6171
"Passaic County","Passaic County, New Jersey","050","00","1","2","34031","34","031",453060,364983,88077,37804,50273
"Salem County","Salem County, New Jersey","050","00","1","2","34033","34","033",65294,63978,1316,913,403
"Somerset County","Somerset County, New Jersey","050","00","1","2","34035","34","035",240279,214104,26175,14321,11854
"Sussex County","Sussex County, New Jersey","050","00","1","2","34037","34","037",130943,124796,6147,4112,2035
"Union County","Union County, New Jersey","050","00","1","2","34039","34","039",493819,403084,90735,42164,48571
"Warren County","Warren County, New Jersey","050","00","1","2","34041","34","041",91607,87824,3783,2383,1400
"Bernalillo County","Bernalillo County, New Mexico","050","00","4","8","35001","35","001",480577,455233,25344,10666,14678
"Catron County","Catron County, New Mexico","050","00","4","8","35003","35","003",2563,2521,42,27,15
"Chaves County","Chaves County, New Mexico","050","00","4","8","35005","35","005",57849,53553,4296,1663,2633
"Cibola County","Cibola County, New Mexico","050","00","4","8","35006","35","006",23794,23431,363,221,142
"Colfax County","Colfax County, New Mexico","050","00","4","8","35007","35","007",12925,12726,199,127,72
"Curry County","Curry County, New Mexico","050","00","4","8","35009","35","009",42207,40560,1647,641,1006
"DeBaca County","DeBaca County, New Mexico","050","00","4","8","35011","35","011",2252,2164,88,17,71
"Dona Ana County","Dona Ana County, New Mexico","050","00","4","8","35013","35","013",135510,115171,20339,6141,14198
"Eddy County","Eddy County, New Mexico","050","00","4","8","35015","35","015",48605,46686,1919,960,959
"Grant County","Grant County, New Mexico","050","00","4","8","35017","35","017",27676,26667,1009,667,342
"Guadalupe County","Guadalupe County, New Mexico","050","00","4","8","35019","35","019",4156,4041,115,81,34
"Harding County","Harding County, New Mexico","050","00","4","8","35021","35","021",987,983,4,2,2
"Hidalgo County","Hidalgo County, New Mexico","050","00","4","8","35023","35","023",5958,5567,391,201,190
"Lea County","Lea County, New Mexico","050","00","4","8","35025","35","025",55765,51755,4010,1531,2479
"Lincoln County","Lincoln County, New Mexico","050","00","4","8","35027","35","027",12219,11721,498,211,287
"Los Alamos County","Los Alamos County, New Mexico","050","00","4","8","35028","35","028",18115,17275,840,361,479
"Luna County","Luna County, New Mexico","050","00","4","8","35029","35","029",18110,15620,2490,686,1804
"McKinley County","McKinley County, New Mexico","050","00","4","8","35031","35","031",60686,59580,1106,634,472
"Mora County","Mora County, New Mexico","050","00","4","8","35033","35","033",4264,4241,23,7,16
"Otero County","Otero County, New Mexico","050","00","4","8","35035","35","035",51928,48963,2965,1584,1381
"Quay County","Quay County, New Mexico","050","00","4","8","35037","35","037",10823,10639,184,71,113
"Rio Arriba County","Rio Arriba County, New Mexico","050","00","4","8","35039","35","039",34365,33923,442,119,323
"Roosevelt County","Roosevelt County, New Mexico","050","00","4","8","35041","35","041",16702,15756,946,431,515
"Sandoval County","Sandoval County, New Mexico","050","00","4","8","35043","35","043",63319,61047,2272,1400,872
"San Juan County","San Juan County, New Mexico","050","00","4","8","35045","35","045",91605,90509,1096,426,670
"San Miguel County","San Miguel County, New Mexico","050","00","4","8","35047","35","047",25743,25207,536,189,347
"Santa Fe County","Santa Fe County, New Mexico","050","00","4","8","35049","35","049",98928,94885,4043,1525,2518
"Sierra County","Sierra County, New Mexico","050","00","4","8","35051","35","051",9912,9440,472,286,186
"Socorro County","Socorro County, New Mexico","050","00","4","8","35053","35","053",14764,13958,806,188,618
"Taos County","Taos County, New Mexico","050","00","4","8","35055","35","055",23118,22671,447,219,228
"Torrance County","Torrance County, New Mexico","050","00","4","8","35057","35","057",10285,10057,228,116,112
"Union County","Union County, New Mexico","050","00","4","8","35059","35","059",4124,3997,127,27,100
"Valencia County","Valencia County, New Mexico","050","00","4","8","35061","35","061",45235,44008,1227,490,737
"Albany County","Albany County, New York","050","00","1","2","36001","36","001",292594,276467,16127,10098,6029
"Allegany County","Allegany County, New York","050","00","1","2","36003","36","003",50470,49683,787,385,402
"Bronx County","Bronx County, New York","050","00","1","2","36005","36","005",1203789,928996,274793,109177,165616
"Broome County","Broome County, New York","050","00","1","2","36007","36","007",212160,203055,9105,5530,3575
"Cattaraugus County","Cattaraugus County, New York","050","00","1","2","36009","36","009",84234,83061,1173,763,410
"Cayuga County","Cayuga County, New York","050","00","1","2","36011","36","011",82313,80040,2273,1501,772
"Chautauqua County","Chautauqua County, New York","050","00","1","2","36013","36","013",141895,138697,3198,2255,943
"Chemung County","Chemung County, New York","050","00","1","2","36015","36","015",95195,92994,2201,1315,886
"Chenango County","Chenango County, New York","050","00","1","2","36017","36","017",51768,50947,821,584,237
"Clinton County","Clinton County, New York","050","00","1","2","36019","36","019",85969,82557,3412,1692,1720
"Columbia County","Columbia County, New York","050","00","1","2","36021","36","021",62982,60402,2580,1829,751
"Cortland County","Cortland County, New York","050","00","1","2","36023","36","023",48963,47890,1073,797,276
"Delaware County","Delaware County, New York","050","00","1","2","36025","36","025",47225,45917,1308,909,399
"Dutchess County","Dutchess County, New York","050","00","1","2","36027","36","027",259462,241443,18019,10720,7299
"Erie County","Erie County, New York","050","00","1","2","36029","36","029",968532,925582,42950,27385,15565
"Essex County","Essex County, New York","050","00","1","2","36031","36","031",37152,35856,1296,580,716
"Franklin County","Franklin County, New York","050","00","1","2","36033","36","033",46540,44630,1910,1109,801
"Fulton County","Fulton County, New York","050","00","1","2","36035","36","035",54191,52981,1210,783,427
"Genesee County","Genesee County, New York","050","00","1","2","36037","36","037",60060,58859,1201,831,370
"Greene County","Greene County, New York","050","00","1","2","36039","36","039",44739,41845,2894,2162,732
"Hamilton County","Hamilton County, New York","050","00","1","2","36041","36","041",5279,5168,111,72,39
"Herkimer County","Herkimer County, New York","050","00","1","2","36043","36","043",65797,64382,1415,1180,235
"Jefferson County","Jefferson County, New York","050","00","1","2","36045","36","045",110943,107797,3146,1662,1484
"Kings County","Kings County, New York","050","00","1","2","36047","36","047",2300664,1628095,672569,278923,393646
"Lewis County","Lewis County, New York","050","00","1","2","36049","36","049",26796,26459,337,233,104
"Livingston County","Livingston County, New York","050","00","1","2","36051","36","051",62372,61063,1309,755,554
"Madison County","Madison County, New York","050","00","1","2","36053","36","053",69120,67672,1448,850,598
"Monroe County","Monroe County, New York","050","00","1","2","36055","36","055",713968,668395,45573,27298,18275
"Montgomery County","Montgomery County, New York","050","00","1","2","36057","36","057",51981,50133,1848,1236,612
"Nassau County","Nassau County, New York","050","00","1","2","36059","36","059",1287348,1118037,169311,94324,74987
"New York County","New York County, New York","050","00","1","2","36061","36","061",1487536,1103670,383866,152980,230886
"Niagara County","Niagara County, New York","050","00","1","2","36063","36","063",220756,211486,9270,6364,2906
"Oneida County","Oneida County, New York","050","00","1","2","36065","36","065",250836,241779,9057,5961,3096
"Onondaga County","Onondaga County, New York","050","00","1","2","36067","36","067",468973,447376,21597,12997,8600
"Ontario County","Ontario County, New York","050","00","1","2","36069","36","069",95101,93141,1960,1255,705
"Orange County","Orange County, New York","050","00","1","2","36071","36","071",307647,285574,22073,12785,9288
"Orleans County","Orleans County, New York","050","00","1","2","36073","36","073",41846,40947,899,538,361
"Oswego County","Oswego County, New York","050","00","1","2","36075","36","075",121771,119633,2138,1257,881
"Otsego County","Otsego County, New York","050","00","1","2","36077","36","077",60517,58951,1566,1046,520
"Putnam County","Putnam County, New York","050","00","1","2","36079","36","079",83941,78271,5670,3774,1896
"Queens County","Queens County, New York","050","00","1","2","36081","36","081",1951598,1244445,707153,298991,408162
"Rensselaer County","Rensselaer County, New York","050","00","1","2","36083","36","083",154429,148514,5915,3291,2624
"Richmond County","Richmond County, New York","050","00","1","2","36085","36","085",378977,334427,44550,25345,19205
"Rockland County","Rockland County, New York","050","00","1","2","36087","36","087",265475,226677,38798,21062,17736
"St. Lawrence County","St. Lawrence County, New York","050","00","1","2","36089","36","089",111974,108107,3867,2111,1756
"Saratoga County","Saratoga County, New York","050","00","1","2","36091","36","091",181276,176630,4646,2887,1759
"Schenectady County","Schenectady County, New York","050","00","1","2","36093","36","093",149285,141853,7432,5395,2037
"Schoharie County","Schoharie County, New York","050","00","1","2","36095","36","095",31859,30948,911,683,228
"Schuyler County","Schuyler County, New York","050","00","1","2","36097","36","097",18662,18364,298,226,72
"Seneca County","Seneca County, New York","050","00","1","2","36099","36","099",33683,32941,742,520,222
"Steuben County","Steuben County, New York","050","00","1","2","36101","36","101",99088,97425,1663,1031,632
"Suffolk County","Suffolk County, New York","050","00","1","2","36103","36","103",1321864,1217653,104211,58861,45350
"Sullivan County","Sullivan County, New York","050","00","1","2","36105","36","105",69277,64234,5043,3216,1827
"Tioga County","Tioga County, New York","050","00","1","2","36107","36","107",52337,51347,990,751,239
"Tompkins County","Tompkins County, New York","050","00","1","2","36109","36","109",94097,86097,8000,2726,5274
"Ulster County","Ulster County, New York","050","00","1","2","36111","36","111",165304,155731,9573,6288,3285
"Warren County","Warren County, New York","050","00","1","2","36113","36","113",59209,57563,1646,1006,640
"Washington County","Washington County, New York","050","00","1","2","36115","36","115",59330,58046,1284,691,593
"Wayne County","Wayne County, New York","050","00","1","2","36117","36","117",89123,87308,1815,1203,612
"Westchester County","Westchester County, New York","050","00","1","2","36119","36","119",874866,716269,158597,74123,84474
"Wyoming County","Wyoming County, New York","050","00","1","2","36121","36","121",42507,41579,928,470,458
"Yates County","Yates County, New York","050","00","1","2","36123","36","123",22810,22505,305,248,57
"Alamance County","Alamance County, North Carolina","050","00","3","5","37001","37","001",108213,107043,1170,570,600
"Alexander County","Alexander County, North Carolina","050","00","3","5","37003","37","003",27544,27458,86,36,50
"Alleghany County","Alleghany County, North Carolina","050","00","3","5","37005","37","005",9590,9502,88,18,70
"Anson County","Anson County, North Carolina","050","00","3","5","37007","37","007",23474,23428,46,27,19
"Ashe County","Ashe County, North Carolina","050","00","3","5","37009","37","009",22209,22037,172,79,93
"Avery County","Avery County, North Carolina","050","00","3","5","37011","37","011",14867,14723,144,32,112
"Beaufort County","Beaufort County, North Carolina","050","00","3","5","37013","37","013",42283,42029,254,126,128
"Bertie County","Bertie County, North Carolina","050","00","3","5","37015","37","015",20388,20349,39,12,27
"Bladen County","Bladen County, North Carolina","050","00","3","5","37017","37","017",28663,28539,124,40,84
"Brunswick County","Brunswick County, North Carolina","050","00","3","5","37019","37","019",50985,50477,508,292,216
"Buncombe County","Buncombe County, North Carolina","050","00","3","5","37021","37","021",174821,172164,2657,1384,1273
"Burke County","Burke County, North Carolina","050","00","3","5","37023","37","023",75744,75075,669,260,409
"Cabarrus County","Cabarrus County, North Carolina","050","00","3","5","37025","37","025",98935,98009,926,415,511
"Caldwell County","Caldwell County, North Carolina","050","00","3","5","37027","37","027",70709,70353,356,164,192
"Camden County","Camden County, North Carolina","050","00","3","5","37029","37","029",5904,5850,54,12,42
"Carteret County","Carteret County, North Carolina","050","00","3","5","37031","37","031",52556,51960,596,315,281
"Caswell County","Caswell County, North Carolina","050","00","3","5","37033","37","033",20693,20594,99,68,31
"Catawba County","Catawba County, North Carolina","050","00","3","5","37035","37","035",118412,116967,1445,519,926
"Chatham County","Chatham County, North Carolina","050","00","3","5","37037","37","037",38759,37985,774,391,383
"Cherokee County","Cherokee County, North Carolina","050","00","3","5","37039","37","039",20170,20010,160,76,84
"Chowan County","Chowan County, North Carolina","050","00","3","5","37041","37","041",13506,13431,75,49,26
"Clay County","Clay County, North Carolina","050","00","3","5","37043","37","043",7155,7122,33,30,3
"Cleveland County","Cleveland County, North Carolina","050","00","3","5","37045","37","045",84714,83909,805,313,492
"Columbus County","Columbus County, North Carolina","050","00","3","5","37047","37","047",49587,49376,211,85,126
"Craven County","Craven County, North Carolina","050","00","3","5","37049","37","049",81613,80072,1541,881,660
"Cumberland County","Cumberland County, North Carolina","050","00","3","5","37051","37","051",274566,264000,10566,6065,4501
"Currituck County","Currituck County, North Carolina","050","00","3","5","37053","37","053",13736,13669,67,52,15
"Dare County","Dare County, North Carolina","050","00","3","5","37055","37","055",22746,22397,349,189,160
"Davidson County","Davidson County, North Carolina","050","00","3","5","37057","37","057",126677,125786,891,397,494
"Davie County","Davie County, North Carolina","050","00","3","5","37059","37","059",27859,27624,235,84,151
"Duplin County","Duplin County, North Carolina","050","00","3","5","37061","37","061",39995,39339,656,126,530
"Durham County","Durham County, North Carolina","050","00","3","5","37063","37","063",181835,175468,6367,2014,4353
"Edgecombe County","Edgecombe County, North Carolina","050","00","3","5","37065","37","065",56558,56435,123,85,38
"Forsyth County","Forsyth County, North Carolina","050","00","3","5","37067","37","067",265878,261225,4653,2059,2594
"Franklin County","Franklin County, North Carolina","050","00","3","5","37069","37","069",36414,36235,179,129,50
"Gaston County","Gaston County, North Carolina","050","00","3","5","37071","37","071",175093,173533,1560,849,711
"Gates County","Gates County, North Carolina","050","00","3","5","37073","37","073",9305,9278,27,14,13
"Graham County","Graham County, North Carolina","050","00","3","5","37075","37","075",7196,7189,7,7,0
"Granville County","Granville County, North Carolina","050","00","3","5","37077","37","077",38345,38053,292,108,184
"Greene County","Greene County, North Carolina","050","00","3","5","37079","37","079",15384,15274,110,23,87
"Guilford County","Guilford County, North Carolina","050","00","3","5","37081","37","081",347420,340340,7080,2514,4566
"Halifax County","Halifax County, North Carolina","050","00","3","5","37083","37","083",55516,55280,236,67,169
"Harnett County","Harnett County, North Carolina","050","00","3","5","37085","37","085",67822,66922,900,445,455
"Haywood County","Haywood County, North Carolina","050","00","3","5","37087","37","087",46942,46664,278,216,62
"Henderson County","Henderson County, North Carolina","050","00","3","5","37089","37","089",69285,67738,1547,1008,539
"Hertford County","Hertford County, North Carolina","050","00","3","5","37091","37","091",22523,22286,237,80,157
"Hoke County","Hoke County, North Carolina","050","00","3","5","37093","37","093",22856,22680,176,72,104
"Hyde County","Hyde County, North Carolina","050","00","3","5","37095","37","095",5411,5368,43,29,14
"Iredell County","Iredell County, North Carolina","050","00","3","5","37097","37","097",92931,91881,1050,388,662
"Jackson County","Jackson County, North Carolina","050","00","3","5","37099","37","099",26846,26468,378,121,257
"Johnston County","Johnston County, North Carolina","050","00","3","5","37101","37","101",81306,80492,814,311,503
"Jones County","Jones County, North Carolina","050","00","3","5","37103","37","103",9414,9367,47,42,5
"Lee County","Lee County, North Carolina","050","00","3","5","37105","37","105",41374,40604,770,374,396
"Lenoir County","Lenoir County, North Carolina","050","00","3","5","37107","37","107",57274,56715,559,360,199
"Lincoln County","Lincoln County, North Carolina","050","00","3","5","37109","37","109",50319,49816,503,265,238
"McDowell County","McDowell County, North Carolina","050","00","3","5","37111","37","111",35681,35444,237,131,106
"Macon County","Macon County, North Carolina","050","00","3","5","37113","37","113",23499,23234,265,168,97
"Madison County","Madison County, North Carolina","050","00","3","5","37115","37","115",16953,16820,133,52,81
"Martin County","Martin County, North Carolina","050","00","3","5","37117","37","117",25078,24987,91,37,54
"Mecklenburg County","Mecklenburg County, North Carolina","050","00","3","5","37119","37","119",511433,493558,17875,6740,11135
"Mitchell County","Mitchell County, North Carolina","050","00","3","5","37121","37","121",14433,14382,51,27,24
"Montgomery County","Montgomery County, North Carolina","050","00","3","5","37123","37","123",23346,22828,518,110,408
"Moore County","Moore County, North Carolina","050","00","3","5","37125","37","125",59013,58079,934,481,453
"Nash County","Nash County, North Carolina","050","00","3","5","37127","37","127",76677,76143,534,157,377
"New Hanover County","New Hanover County, North Carolina","050","00","3","5","37129","37","129",120284,118455,1829,1121,708
"Northampton County","Northampton County, North Carolina","050","00","3","5","37131","37","131",20798,20759,39,16,23
"Onslow County","Onslow County, North Carolina","050","00","3","5","37133","37","133",149838,144531,5307,2217,3090
"Orange County","Orange County, North Carolina","050","00","3","5","37135","37","135",93851,89156,4695,1467,3228
"Pamlico County","Pamlico County, North Carolina","050","00","3","5","37137","37","137",11372,11276,96,49,47
"Pasquotank County","Pasquotank County, North Carolina","050","00","3","5","37139","37","139",31298,31037,261,149,112
"Pender County","Pender County, North Carolina","050","00","3","5","37141","37","141",28855,28550,305,187,118
"Perquimans County","Perquimans County, North Carolina","050","00","3","5","37143","37","143",10447,10389,58,47,11
"Person County","Person County, North Carolina","050","00","3","5","37145","37","145",30180,30067,113,36,77
"Pitt County","Pitt County, North Carolina","050","00","3","5","37147","37","147",107924,106602,1322,608,714
"Polk County","Polk County, North Carolina","050","00","3","5","37149","37","149",14416,14118,298,178,120
"Randolph County","Randolph County, North Carolina","050","00","3","5","37151","37","151",106546,105626,920,421,499
"Richmond County","Richmond County, North Carolina","050","00","3","5","37153","37","153",44518,44235,283,170,113
"Robeson County","Robeson County, North Carolina","050","00","3","5","37155","37","155",105179,104686,493,261,232
"Rockingham County","Rockingham County, North Carolina","050","00","3","5","37157","37","157",86064,85646,418,123,295
"Rowan County","Rowan County, North Carolina","050","00","3","5","37159","37","159",110605,109698,907,310,597
"Rutherford County","Rutherford County, North Carolina","050","00","3","5","37161","37","161",56918,56753,165,110,55
"Sampson County","Sampson County, North Carolina","050","00","3","5","37163","37","163",47297,46954,343,183,160
"Scotland County","Scotland County, North Carolina","050","00","3","5","37165","37","165",33754,33436,318,192,126
"Stanly County","Stanly County, North Carolina","050","00","3","5","37167","37","167",51765,51315,450,176,274
"Stokes County","Stokes County, North Carolina","050","00","3","5","37169","37","169",37223,37059,164,77,87
"Surry County","Surry County, North Carolina","050","00","3","5","37171","37","171",61704,61262,442,212,230
"Swain County","Swain County, North Carolina","050","00","3","5","37173","37","173",11268,11219,49,20,29
"Transylvania County","Transylvania County, North Carolina","050","00","3","5","37175","37","175",25520,25102,418,249,169
"Tyrrell County","Tyrrell County, North Carolina","050","00","3","5","37177","37","177",3856,3833,23,2,21
"Union County","Union County, North Carolina","050","00","3","5","37179","37","179",84211,83541,670,289,381
"Vance County","Vance County, North Carolina","050","00","3","5","37181","37","181",38892,38552,340,176,164
"Wake County","Wake County, North Carolina","050","00","3","5","37183","37","183",423380,406835,16545,6365,10180
"Warren County","Warren County, North Carolina","050","00","3","5","37185","37","185",17265,17152,113,43,70
"Washington County","Washington County, North Carolina","050","00","3","5","37187","37","187",13997,13939,58,33,25
"Watauga County","Watauga County, North Carolina","050","00","3","5","37189","37","189",36952,36486,466,272,194
"Wayne County","Wayne County, North Carolina","050","00","3","5","37191","37","191",104666,102890,1776,826,950
"Wilkes County","Wilkes County, North Carolina","050","00","3","5","37193","37","193",59393,59203,190,121,69
"Wilson County","Wilson County, North Carolina","050","00","3","5","37195","37","195",66061,65530,531,178,353
"Yadkin County","Yadkin County, North Carolina","050","00","3","5","37197","37","197",30488,30283,205,70,135
"Yancey County","Yancey County, North Carolina","050","00","3","5","37199","37","199",15419,15322,97,72,25
"Adams County","Adams County, North Dakota","050","00","2","4","38001","38","001",3174,3139,35,31,4
"Barnes County","Barnes County, North Dakota","050","00","2","4","38003","38","003",12545,12431,114,75,39
"Benson County","Benson County, North Dakota","050","00","2","4","38005","38","005",7198,7161,37,23,14
"Billings County","Billings County, North Dakota","050","00","2","4","38007","38","007",1108,1100,8,8,0
"Bottineau County","Bottineau County, North Dakota","050","00","2","4","38009","38","009",8011,7914,97,55,42
"Bowman County","Bowman County, North Dakota","050","00","2","4","38011","38","011",3596,3580,16,16,0
"Burke County","Burke County, North Dakota","050","00","2","4","38013","38","013",3002,2935,67,47,20
"Burleigh County","Burleigh County, North Dakota","050","00","2","4","38015","38","015",60131,59482,649,421,228
"Cass County","Cass County, North Dakota","050","00","2","4","38017","38","017",102874,101162,1712,815,897
"Cavalier County","Cavalier County, North Dakota","050","00","2","4","38019","38","019",6064,5953,111,95,16
"Dickey County","Dickey County, North Dakota","050","00","2","4","38021","38","021",6107,6020,87,48,39
"Divide County","Divide County, North Dakota","050","00","2","4","38023","38","023",2899,2824,75,57,18
"Dunn County","Dunn County, North Dakota","050","00","2","4","38025","38","025",4005,3967,38,33,5
"Eddy County","Eddy County, North Dakota","050","00","2","4","38027","38","027",2951,2918,33,26,7
"Emmons County","Emmons County, North Dakota","050","00","2","4","38029","38","029",4830,4811,19,17,2
"Foster County","Foster County, North Dakota","050","00","2","4","38031","38","031",3983,3953,30,20,10
"Golden Valley County","Golden Valley County, North Dakota","050","00","2","4","38033","38","033",2108,2093,15,7,8
"Grand Forks County","Grand Forks County, North Dakota","050","00","2","4","38035","38","035",70683,69110,1573,679,894
"Grant County","Grant County, North Dakota","050","00","2","4","38037","38","037",3549,3490,59,59,0
"Griggs County","Griggs County, North Dakota","050","00","2","4","38039","38","039",3303,3273,30,28,2
"Hettinger County","Hettinger County, North Dakota","050","00","2","4","38041","38","041",3445,3406,39,37,2
"Kidder County","Kidder County, North Dakota","050","00","2","4","38043","38","043",3332,3298,34,23,11
"LaMoure County","LaMoure County, North Dakota","050","00","2","4","38045","38","045",5383,5316,67,59,8
"Logan County","Logan County, North Dakota","050","00","2","4","38047","38","047",2847,2821,26,26,0
"McHenry County","McHenry County, North Dakota","050","00","2","4","38049","38","049",6528,6467,61,55,6
"McIntosh County","McIntosh County, North Dakota","050","00","2","4","38051","38","051",4021,3939,82,78,4
"McKenzie County","McKenzie County, North Dakota","050","00","2","4","38053","38","053",6383,6318,65,38,27
"McLean County","McLean County, North Dakota","050","00","2","4","38055","38","055",10457,10366,91,70,21
"Mercer County","Mercer County, North Dakota","050","00","2","4","38057","38","057",9808,9680,128,96,32
"Morton County","Morton County, North Dakota","050","00","2","4","38059","38","059",23700,23414,286,262,24
"Mountrail County","Mountrail County, North Dakota","050","00","2","4","38061","38","061",7021,6978,43,43,0
"Nelson County","Nelson County, North Dakota","050","00","2","4","38063","38","063",4410,4370,40,40,0
"Oliver County","Oliver County, North Dakota","050","00","2","4","38065","38","065",2381,2356,25,25,0
"Pembina County","Pembina County, North Dakota","050","00","2","4","38067","38","067",9238,8962,276,204,72
"Pierce County","Pierce County, North Dakota","050","00","2","4","38069","38","069",5052,4993,59,40,19
"Ramsey County","Ramsey County, North Dakota","050","00","2","4","38071","38","071",12681,12533,148,123,25
"Ransom County","Ransom County, North Dakota","050","00","2","4","38073","38","073",5921,5869,52,35,17
"Renville County","Renville County, North Dakota","050","00","2","4","38075","38","075",3160,3116,44,40,4
"Richland County","Richland County, North Dakota","050","00","2","4","38077","38","077",18148,17908,240,120,120
"Rolette County","Rolette County, North Dakota","050","00","2","4","38079","38","079",12772,12699,73,43,30
"Sargent County","Sargent County, North Dakota","050","00","2","4","38081","38","081",4549,4531,18,18,0
"Sheridan County","Sheridan County, North Dakota","050","00","2","4","38083","38","083",2148,2115,33,20,13
"Sioux County","Sioux County, North Dakota","050","00","2","4","38085","38","085",3761,3754,7,7,0
"Slope County","Slope County, North Dakota","050","00","2","4","38087","38","087",907,907,0,0,0
"Stark County","Stark County, North Dakota","050","00","2","4","38089","38","089",22832,22582,250,177,73
"Steele County","Steele County, North Dakota","050","00","2","4","38091","38","091",2420,2401,19,16,3
"Stutsman County","Stutsman County, North Dakota","050","00","2","4","38093","38","093",22241,22006,235,161,74
"Towner County","Towner County, North Dakota","050","00","2","4","38095","38","095",3627,3581,46,27,19
"Traill County","Traill County, North Dakota","050","00","2","4","38097","38","097",8752,8634,118,63,55
"Walsh County","Walsh County, North Dakota","050","00","2","4","38099","38","099",13840,13572,268,203,65
"Ward County","Ward County, North Dakota","050","00","2","4","38101","38","101",57921,56600,1321,684,637
"Wells County","Wells County, North Dakota","050","00","2","4","38103","38","103",5864,5805,59,43,16
"Williams County","Williams County, North Dakota","050","00","2","4","38105","38","105",21129,20799,330,218,112
"Adams County","Adams County, Ohio","050","00","2","3","39001","39","001",25371,25283,88,35,53
"Allen County","Allen County, Ohio","050","00","2","3","39003","39","003",109755,108831,924,587,337
"Ashland County","Ashland County, Ohio","050","00","2","3","39005","39","005",47507,47010,497,273,224
"Ashtabula County","Ashtabula County, Ohio","050","00","2","3","39007","39","007",99821,98185,1636,1163,473
"Athens County","Athens County, Ohio","050","00","2","3","39009","39","009",59549,57411,2138,391,1747
"Auglaize County","Auglaize County, Ohio","050","00","2","3","39011","39","011",44585,44355,230,184,46
"Belmont County","Belmont County, Ohio","050","00","2","3","39013","39","013",71074,70287,787,684,103
"Brown County","Brown County, Ohio","050","00","2","3","39015","39","015",34966,34898,68,43,25
"Butler County","Butler County, Ohio","050","00","2","3","39017","39","017",291479,287259,4220,2213,2007
"Carroll County","Carroll County, Ohio","050","00","2","3","39019","39","019",26521,26372,149,121,28
"Champaign County","Champaign County, Ohio","050","00","2","3","39021","39","021",36019,35784,235,118,117
"Clark County","Clark County, Ohio","050","00","2","3","39023","39","023",147548,146073,1475,876,599
"Clermont County","Clermont County, Ohio","050","00","2","3","39025","39","025",150187,148905,1282,699,583
"Clinton County","Clinton County, Ohio","050","00","2","3","39027","39","027",35415,35157,258,107,151
"Columbiana County","Columbiana County, Ohio","050","00","2","3","39029","39","029",108276,107386,890,671,219
"Coshocton County","Coshocton County, Ohio","050","00","2","3","39031","39","031",35427,35249,178,133,45
"Crawford County","Crawford County, Ohio","050","00","2","3","39033","39","033",47870,47564,306,154,152
"Cuyahoga County","Cuyahoga County, Ohio","050","00","2","3","39035","39","035",1412140,1332595,79545,52205,27340
"Darke County","Darke County, Ohio","050","00","2","3","39037","39","037",53619,53328,291,163,128
"Defiance County","Defiance County, Ohio","050","00","2","3","39039","39","039",39350,39027,323,186,137
"Delaware County","Delaware County, Ohio","050","00","2","3","39041","39","041",66929,65790,1139,508,631
"Erie County","Erie County, Ohio","050","00","2","3","39043","39","043",76779,75652,1127,757,370
"Fairfield County","Fairfield County, Ohio","050","00","2","3","39045","39","045",103461,102527,934,561,373
"Fayette County","Fayette County, Ohio","050","00","2","3","39047","39","047",27466,27254,212,58,154
"Franklin County","Franklin County, Ohio","050","00","2","3","39049","39","049",961437,929202,32235,13261,18974
"Fulton County","Fulton County, Ohio","050","00","2","3","39051","39","051",38498,37930,568,285,283
"Gallia County","Gallia County, Ohio","050","00","2","3","39053","39","053",30954,30694,260,116,144
"Geauga County","Geauga County, Ohio","050","00","2","3","39055","39","055",81129,78501,2628,1753,875
"Greene County","Greene County, Ohio","050","00","2","3","39057","39","057",136731,133387,3344,1857,1487
"Guernsey County","Guernsey County, Ohio","050","00","2","3","39059","39","059",39024,38787,237,160,77
"Hamilton County","Hamilton County, Ohio","050","00","2","3","39061","39","061",866228,843952,22276,12371,9905
"Hancock County","Hancock County, Ohio","050","00","2","3","39063","39","063",65536,64679,857,365,492
"Hardin County","Hardin County, Ohio","050","00","2","3","39065","39","065",31111,30904,207,110,97
"Harrison County","Harrison County, Ohio","050","00","2","3","39067","39","067",16085,15993,92,82,10
"Henry County","Henry County, Ohio","050","00","2","3","39069","39","069",29108,28821,287,164,123
"Highland County","Highland County, Ohio","050","00","2","3","39071","39","071",35728,35533,195,109,86
"Hocking County","Hocking County, Ohio","050","00","2","3","39073","39","073",25533,25415,118,91,27
"Holmes County","Holmes County, Ohio","050","00","2","3","39075","39","075",32849,32682,167,106,61
"Huron County","Huron County, Ohio","050","00","2","3","39077","39","077",56240,55676,564,318,246
"Jackson County","Jackson County, Ohio","050","00","2","3","39079","39","079",30230,30141,89,60,29
"Jefferson County","Jefferson County, Ohio","050","00","2","3","39081","39","081",80298,79020,1278,929,349
"Knox County","Knox County, Ohio","050","00","2","3","39083","39","083",47473,47004,469,261,208
"Lake County","Lake County, Ohio","050","00","2","3","39085","39","085",215499,208468,7031,5207,1824
"Lawrence County","Lawrence County, Ohio","050","00","2","3","39087","39","087",61834,61628,206,147,59
"Licking County","Licking County, Ohio","050","00","2","3","39089","39","089",128300,127328,972,605,367
"Logan County","Logan County, Ohio","050","00","2","3","39091","39","091",42310,41965,345,136,209
"Lorain County","Lorain County, Ohio","050","00","2","3","39093","39","093",271126,264746,6380,4400,1980
"Lucas County","Lucas County, Ohio","050","00","2","3","39095","39","095",462361,449792,12569,7022,5547
"Madison County","Madison County, Ohio","050","00","2","3","39097","39","097",37068,36780,288,102,186
"Mahoning County","Mahoning County, Ohio","050","00","2","3","39099","39","099",264806,257137,7669,6199,1470
"Marion County","Marion County, Ohio","050","00","2","3","39101","39","101",64274,63655,619,378,241
"Medina County","Medina County, Ohio","050","00","2","3","39103","39","103",122354,119569,2785,1843,942
"Meigs County","Meigs County, Ohio","050","00","2","3","39105","39","105",22987,22906,81,47,34
"Mercer County","Mercer County, Ohio","050","00","2","3","39107","39","107",39443,39239,204,126,78
"Miami County","Miami County, Ohio","050","00","2","3","39109","39","109",93182,92132,1050,552,498
"Monroe County","Monroe County, Ohio","050","00","2","3","39111","39","111",15497,15469,28,17,11
"Montgomery County","Montgomery County, Ohio","050","00","2","3","39113","39","113",573809,562464,11345,6496,4849
"Morgan County","Morgan County, Ohio","050","00","2","3","39115","39","115",14194,14150,44,29,15
"Morrow County","Morrow County, Ohio","050","00","2","3","39117","39","117",27749,27609,140,89,51
"Muskingum County","Muskingum County, Ohio","050","00","2","3","39119","39","119",82068,81521,547,321,226
"Noble County","Noble County, Ohio","050","00","2","3","39121","39","121",11336,11299,37,33,4
"Ottawa County","Ottawa County, Ohio","050","00","2","3","39123","39","123",40029,39552,477,330,147
"Paulding County","Paulding County, Ohio","050","00","2","3","39125","39","125",20488,20392,96,73,23
"Perry County","Perry County, Ohio","050","00","2","3","39127","39","127",31557,31433,124,85,39
"Pickaway County","Pickaway County, Ohio","050","00","2","3","39129","39","129",48255,47944,311,155,156
"Pike County","Pike County, Ohio","050","00","2","3","39131","39","131",24249,24197,52,21,31
"Portage County","Portage County, Ohio","050","00","2","3","39133","39","133",142585,139498,3087,1610,1477
"Preble County","Preble County, Ohio","050","00","2","3","39135","39","135",40113,39972,141,84,57
"Putnam County","Putnam County, Ohio","050","00","2","3","39137","39","137",33819,33656,163,81,82
"Richland County","Richland County, Ohio","050","00","2","3","39139","39","139",126137,123619,2518,1823,695
"Ross County","Ross County, Ohio","050","00","2","3","39141","39","141",69330,68781,549,310,239
"Sandusky County","Sandusky County, Ohio","050","00","2","3","39143","39","143",61963,61249,714,390,324
"Scioto County","Scioto County, Ohio","050","00","2","3","39145","39","145",80327,79987,340,218,122
"Seneca County","Seneca County, Ohio","050","00","2","3","39147","39","147",59733,59113,620,374,246
"Shelby County","Shelby County, Ohio","050","00","2","3","39149","39","149",44915,44356,559,237,322
"Stark County","Stark County, Ohio","050","00","2","3","39151","39","151",367585,361097,6488,4577,1911
"Summit County","Summit County, Ohio","050","00","2","3","39153","39","153",514990,499814,15176,8871,6305
"Trumbull County","Trumbull County, Ohio","050","00","2","3","39155","39","155",227813,223164,4649,3541,1108
"Tuscarawas County","Tuscarawas County, Ohio","050","00","2","3","39157","39","157",84090,83388,702,538,164
"Union County","Union County, Ohio","050","00","2","3","39159","39","159",31969,31734,235,83,152
"Van Wert County","Van Wert County, Ohio","050","00","2","3","39161","39","161",30464,30361,103,86,17
"Vinton County","Vinton County, Ohio","050","00","2","3","39163","39","163",11098,11094,4,4,0
"Warren County","Warren County, Ohio","050","00","2","3","39165","39","165",113909,112678,1231,624,607
"Washington County","Washington County, Ohio","050","00","2","3","39167","39","167",62254,61857,397,232,165
"Wayne County","Wayne County, Ohio","050","00","2","3","39169","39","169",101461,100374,1087,472,615
"Williams County","Williams County, Ohio","050","00","2","3","39171","39","171",36956,36668,288,130,158
"Wood County","Wood County, Ohio","050","00","2","3","39173","39","173",113269,111001,2268,1185,1083
"Wyandot County","Wyandot County, Ohio","050","00","2","3","39175","39","175",22254,22103,151,73,78
"Adair County","Adair County, Oklahoma","050","00","3","7","40001","40","001",18421,18368,53,40,13
"Alfalfa County","Alfalfa County, Oklahoma","050","00","3","7","40003","40","003",6416,6367,49,12,37
"Atoka County","Atoka County, Oklahoma","050","00","3","7","40005","40","005",12778,12726,52,24,28
"Beaver County","Beaver County, Oklahoma","050","00","3","7","40007","40","007",6023,5838,185,6,179
"Beckham County","Beckham County, Oklahoma","050","00","3","7","40009","40","009",18812,18620,192,126,66
"Blaine County","Blaine County, Oklahoma","050","00","3","7","40011","40","011",11470,11337,133,72,61
"Bryan County","Bryan County, Oklahoma","050","00","3","7","40013","40","013",32089,31842,247,105,142
"Caddo County","Caddo County, Oklahoma","050","00","3","7","40015","40","015",29550,29171,379,157,222
"Canadian County","Canadian County, Oklahoma","050","00","3","7","40017","40","017",74409,72968,1441,799,642
"Carter County","Carter County, Oklahoma","050","00","3","7","40019","40","019",42919,42525,394,186,208
"Cherokee County","Cherokee County, Oklahoma","050","00","3","7","40021","40","021",34049,33855,194,77,117
"Choctaw County","Choctaw County, Oklahoma","050","00","3","7","40023","40","023",15302,15238,64,35,29
"Cimarron County","Cimarron County, Oklahoma","050","00","3","7","40025","40","025",3301,3167,134,51,83
"Cleveland County","Cleveland County, Oklahoma","050","00","3","7","40027","40","027",174253,168821,5432,2115,3317
"Coal County","Coal County, Oklahoma","050","00","3","7","40029","40","029",5780,5765,15,13,2
"Comanche County","Comanche County, Oklahoma","050","00","3","7","40031","40","031",111486,105813,5673,3449,2224
"Cotton County","Cotton County, Oklahoma","050","00","3","7","40033","40","033",6651,6555,96,46,50
"Craig County","Craig County, Oklahoma","050","00","3","7","40035","40","035",14104,14042,62,33,29
"Creek County","Creek County, Oklahoma","050","00","3","7","40037","40","037",60915,60541,374,250,124
"Custer County","Custer County, Oklahoma","050","00","3","7","40039","40","039",26897,26111,786,328,458
"Delaware County","Delaware County, Oklahoma","050","00","3","7","40041","40","041",28070,27895,175,77,98
"Dewey County","Dewey County, Oklahoma","050","00","3","7","40043","40","043",5551,5541,10,6,4
"Ellis County","Ellis County, Oklahoma","050","00","3","7","40045","40","045",4497,4458,39,9,30
"Garfield County","Garfield County, Oklahoma","050","00","3","7","40047","40","047",56735,55936,799,421,378
"Garvin County","Garvin County, Oklahoma","050","00","3","7","40049","40","049",26605,26520,85,50,35
"Grady County","Grady County, Oklahoma","050","00","3","7","40051","40","051",41747,41443,304,147,157
"Grant County","Grant County, Oklahoma","050","00","3","7","40053","40","053",5689,5659,30,8,22
"Greer County","Greer County, Oklahoma","050","00","3","7","40055","40","055",6559,6521,38,34,4
"Harmon County","Harmon County, Oklahoma","050","00","3","7","40057","40","057",3793,3703,90,21,69
"Harper County","Harper County, Oklahoma","050","00","3","7","40059","40","059",4063,4005,58,23,35
"Haskell County","Haskell County, Oklahoma","050","00","3","7","40061","40","061",10940,10849,91,11,80
"Hughes County","Hughes County, Oklahoma","050","00","3","7","40063","40","063",13023,12996,27,5,22
"Jackson County","Jackson County, Oklahoma","050","00","3","7","40065","40","065",28764,27961,803,348,455
"Jefferson County","Jefferson County, Oklahoma","050","00","3","7","40067","40","067",7010,6888,122,64,58
"Johnston County","Johnston County, Oklahoma","050","00","3","7","40069","40","069",10032,9972,60,23,37
"Kay County","Kay County, Oklahoma","050","00","3","7","40071","40","071",48056,47595,461,263,198
"Kingfisher County","Kingfisher County, Oklahoma","050","00","3","7","40073","40","073",13212,13018,194,74,120
"Kiowa County","Kiowa County, Oklahoma","050","00","3","7","40075","40","075",11347,11220,127,56,71
"Latimer County","Latimer County, Oklahoma","050","00","3","7","40077","40","077",10333,10270,63,48,15
"Le Flore County","Le Flore County, Oklahoma","050","00","3","7","40079","40","079",43270,43061,209,100,109
"Lincoln County","Lincoln County, Oklahoma","050","00","3","7","40081","40","081",29216,29017,199,164,35
"Logan County","Logan County, Oklahoma","050","00","3","7","40083","40","083",29011,28623,388,271,117
"Love County","Love County, Oklahoma","050","00","3","7","40085","40","085",8157,8067,90,20,70
"McClain County","McClain County, Oklahoma","050","00","3","7","40087","40","087",22795,22544,251,119,132
"McCurtain County","McCurtain County, Oklahoma","050","00","3","7","40089","40","089",33433,33220,213,129,84
"McIntosh County","McIntosh County, Oklahoma","050","00","3","7","40091","40","091",16779,16704,75,38,37
"Major County","Major County, Oklahoma","050","00","3","7","40093","40","093",8055,7988,67,22,45
"Marshall County","Marshall County, Oklahoma","050","00","3","7","40095","40","095",10829,10658,171,67,104
"Mayes County","Mayes County, Oklahoma","050","00","3","7","40097","40","097",33366,33261,105,60,45
"Murray County","Murray County, Oklahoma","050","00","3","7","40099","40","099",12042,12015,27,19,8
"Muskogee County","Muskogee County, Oklahoma","050","00","3","7","40101","40","101",68078,67552,526,246,280
"Noble County","Noble County, Oklahoma","050","00","3","7","40103","40","103",11045,10970,75,32,43
"Nowata County","Nowata County, Oklahoma","050","00","3","7","40105","40","105",9992,9984,8,2,6
"Okfuskee County","Okfuskee County, Oklahoma","050","00","3","7","40107","40","107",11551,11427,124,69,55
"Oklahoma County","Oklahoma County, Oklahoma","050","00","3","7","40109","40","109",599611,577350,22261,9118,13143
"Okmulgee County","Okmulgee County, Oklahoma","050","00","3","7","40111","40","111",36490,36289,201,114,87
"Osage County","Osage County, Oklahoma","050","00","3","7","40113","40","113",41645,41427,218,104,114
"Ottawa County","Ottawa County, Oklahoma","050","00","3","7","40115","40","115",30561,30383,178,94,84
"Pawnee County","Pawnee County, Oklahoma","050","00","3","7","40117","40","117",15575,15515,60,33,27
"Payne County","Payne County, Oklahoma","050","00","3","7","40119","40","119",61507,58721,2786,566,2220
"Pittsburg County","Pittsburg County, Oklahoma","050","00","3","7","40121","40","121",40581,40232,349,201,148
"Pontotoc County","Pontotoc County, Oklahoma","050","00","3","7","40123","40","123",34119,33835,284,96,188
"Pottawatomie County","Pottawatomie County, Oklahoma","050","00","3","7","40125","40","125",58760,58195,565,332,233
"Pushmataha County","Pushmataha County, Oklahoma","050","00","3","7","40127","40","127",10997,10959,38,30,8
"Roger Mills County","Roger Mills County, Oklahoma","050","00","3","7","40129","40","129",4147,4127,20,5,15
"Rogers County","Rogers County, Oklahoma","050","00","3","7","40131","40","131",55170,54725,445,252,193
"Seminole County","Seminole County, Oklahoma","050","00","3","7","40133","40","133",25412,25291,121,92,29
"Sequoyah County","Sequoyah County, Oklahoma","050","00","3","7","40135","40","135",33828,33687,141,62,79
"Stephens County","Stephens County, Oklahoma","050","00","3","7","40137","40","137",42299,41692,607,187,420
"Texas County","Texas County, Oklahoma","050","00","3","7","40139","40","139",16419,16091,328,99,229
"Tillman County","Tillman County, Oklahoma","050","00","3","7","40141","40","141",10384,10104,280,100,180
"Tulsa County","Tulsa County, Oklahoma","050","00","3","7","40143","40","143",503341,490492,12849,5603,7246
"Wagoner County","Wagoner County, Oklahoma","050","00","3","7","40145","40","145",47883,47470,413,224,189
"Washington County","Washington County, Oklahoma","050","00","3","7","40147","40","147",48066,47271,795,376,419
"Washita County","Washita County, Oklahoma","050","00","3","7","40149","40","149",11441,11303,138,73,65
"Woods County","Woods County, Oklahoma","050","00","3","7","40151","40","151",9103,8987,116,50,66
"Woodward County","Woodward County, Oklahoma","050","00","3","7","40153","40","153",18976,18739,237,101,136
"Baker County","Baker County, Oregon","050","00","4","9","41001","41","001",15317,15147,170,123,47
"Benton County","Benton County, Oregon","050","00","4","9","41003","41","003",70811,65666,5145,1490,3655
"Clackamas County","Clackamas County, Oregon","050","00","4","9","41005","41","005",278850,267443,11407,5842,5565
"Clatsop County","Clatsop County, Oregon","050","00","4","9","41007","41","007",33301,32033,1268,778,490
"Columbia County","Columbia County, Oregon","050","00","4","9","41009","41","009",37557,36696,861,484,377
"Coos County","Coos County, Oregon","050","00","4","9","41011","41","011",60273,59022,1251,657,594
"Crook County","Crook County, Oregon","050","00","4","9","41013","41","013",14111,13816,295,157,138
"Curry County","Curry County, Oregon","050","00","4","9","41015","41","015",19327,18840,487,322,165
"Deschutes County","Deschutes County, Oregon","050","00","4","9","41017","41","017",74958,73604,1354,759,595
"Douglas County","Douglas County, Oregon","050","00","4","9","41019","41","019",94649,92745,1904,1117,787
"Gilliam County","Gilliam County, Oregon","050","00","4","9","41021","41","021",1717,1679,38,23,15
"Grant County","Grant County, Oregon","050","00","4","9","41023","41","023",7853,7694,159,88,71
"Harney County","Harney County, Oregon","050","00","4","9","41025","41","025",7060,6912,148,67,81
"Hood River County","Hood River County, Oregon","050","00","4","9","41027","41","027",16903,15118,1785,399,1386
"Jackson County","Jackson County, Oregon","050","00","4","9","41029","41","029",146389,141141,5248,2483,2765
"Jefferson County","Jefferson County, Oregon","050","00","4","9","41031","41","031",13676,12828,848,181,667
"Josephine County","Josephine County, Oregon","050","00","4","9","41033","41","033",62649,60899,1750,1105,645
"Klamath County","Klamath County, Oregon","050","00","4","9","41035","41","035",57702,55788,1914,749,1165
"Lake County","Lake County, Oregon","050","00","4","9","41037","41","037",7186,7007,179,57,122
"Lane County","Lane County, Oregon","050","00","4","9","41039","41","039",282912,273347,9565,4234,5331
"Lincoln County","Lincoln County, Oregon","050","00","4","9","41041","41","041",38889,37950,939,649,290
"Linn County","Linn County, Oregon","050","00","4","9","41043","41","043",91227,89400,1827,1033,794
"Malheur County","Malheur County, Oregon","050","00","4","9","41045","41","045",26038,24540,1498,563,935
"Marion County","Marion County, Oregon","050","00","4","9","41047","41","047",228483,214322,14161,4887,9274
"Morrow County","Morrow County, Oregon","050","00","4","9","41049","41","049",7625,7077,548,173,375
"Multnomah County","Multnomah County, Oregon","050","00","4","9","41051","41","051",583887,542623,41264,17704,23560
"Polk County","Polk County, Oregon","050","00","4","9","41053","41","053",49541,47500,2041,969,1072
"Sherman County","Sherman County, Oregon","050","00","4","9","41055","41","055",1918,1902,16,4,12
"Tillamook County","Tillamook County, Oregon","050","00","4","9","41057","41","057",21570,20903,667,360,307
"Umatilla County","Umatilla County, Oregon","050","00","4","9","41059","41","059",59249,55945,3304,938,2366
"Union County","Union County, Oregon","050","00","4","9","41061","41","061",23598,23217,381,117,264
"Wallowa County","Wallowa County, Oregon","050","00","4","9","41063","41","063",6911,6839,72,40,32
"Wasco County","Wasco County, Oregon","050","00","4","9","41065","41","065",21683,20740,943,339,604
"Washington County","Washington County, Oregon","050","00","4","9","41067","41","067",311554,288694,22860,9400,13460
"Wheeler County","Wheeler County, Oregon","050","00","4","9","41069","41","069",1396,1389,7,0,7
"Yamhill County","Yamhill County, Oregon","050","00","4","9","41071","41","071",65551,62548,3003,911,2092
"Adams County","Adams County, Pennsylvania","050","00","1","2","42001","42","001",78274,77095,1179,541,638
"Allegheny County","Allegheny County, Pennsylvania","050","00","1","2","42003","42","003",1336449,1294444,42005,26131,15874
"Armstrong County","Armstrong County, Pennsylvania","050","00","1","2","42005","42","005",73478,72938,540,432,108
"Beaver County","Beaver County, Pennsylvania","050","00","1","2","42007","42","007",186093,182103,3990,3206,784
"Bedford County","Bedford County, Pennsylvania","050","00","1","2","42009","42","009",47919,47722,197,115,82
"Berks County","Berks County, Pennsylvania","050","00","1","2","42011","42","011",336523,327602,8921,5322,3599
"Blair County","Blair County, Pennsylvania","050","00","1","2","42013","42","013",130542,129304,1238,946,292
"Bradford County","Bradford County, Pennsylvania","050","00","1","2","42015","42","015",60967,60293,674,370,304
"Bucks County","Bucks County, Pennsylvania","050","00","1","2","42017","42","017",541174,519266,21908,14021,7887
"Butler County","Butler County, Pennsylvania","050","00","1","2","42019","42","019",152013,150080,1933,1163,770
"Cambria County","Cambria County, Pennsylvania","050","00","1","2","42021","42","021",163029,161378,1651,1294,357
"Cameron County","Cameron County, Pennsylvania","050","00","1","2","42023","42","023",5913,5863,50,43,7
"Carbon County","Carbon County, Pennsylvania","050","00","1","2","42025","42","025",56846,55734,1112,801,311
"Centre County","Centre County, Pennsylvania","050","00","1","2","42027","42","027",123786,118309,5477,1520,3957
"Chester County","Chester County, Pennsylvania","050","00","1","2","42029","42","029",376396,363156,13240,7040,6200
"Clarion County","Clarion County, Pennsylvania","050","00","1","2","42031","42","031",41699,41342,357,135,222
"Clearfield County","Clearfield County, Pennsylvania","050","00","1","2","42033","42","033",78097,77660,437,314,123
"Clinton County","Clinton County, Pennsylvania","050","00","1","2","42035","42","035",37182,36829,353,181,172
"Columbia County","Columbia County, Pennsylvania","050","00","1","2","42037","42","037",63202,62608,594,332,262
"Crawford County","Crawford County, Pennsylvania","050","00","1","2","42039","42","039",86169,85268,901,634,267
"Cumberland County","Cumberland County, Pennsylvania","050","00","1","2","42041","42","041",195257,190981,4276,2604,1672
"Dauphin County","Dauphin County, Pennsylvania","050","00","1","2","42043","42","043",237813,232155,5658,3264,2394
"Delaware County","Delaware County, Pennsylvania","050","00","1","2","42045","42","045",547651,520880,26771,16143,10628
"Elk County","Elk County, Pennsylvania","050","00","1","2","42047","42","047",34878,34622,256,199,57
"Erie County","Erie County, Pennsylvania","050","00","1","2","42049","42","049",275572,270144,5428,3699,1729
"Fayette County","Fayette County, Pennsylvania","050","00","1","2","42051","42","051",145351,144253,1098,901,197
"Forest County","Forest County, Pennsylvania","050","00","1","2","42053","42","053",4802,4760,42,34,8
"Franklin County","Franklin County, Pennsylvania","050","00","1","2","42055","42","055",121082,119582,1500,942,558
"Fulton County","Fulton County, Pennsylvania","050","00","1","2","42057","42","057",13837,13731,106,88,18
"Greene County","Greene County, Pennsylvania","050","00","1","2","42059","42","059",39550,39216,334,253,81
"Huntingdon County","Huntingdon County, Pennsylvania","050","00","1","2","42061","42","061",44164,43870,294,103,191
"Indiana County","Indiana County, Pennsylvania","050","00","1","2","42063","42","063",89994,88936,1058,538,520
"Jefferson County","Jefferson County, Pennsylvania","050","00","1","2","42065","42","065",46083,45877,206,169,37
"Juniata County","Juniata County, Pennsylvania","050","00","1","2","42067","42","067",20625,20556,69,51,18
"Lackawanna County","Lackawanna County, Pennsylvania","050","00","1","2","42069","42","069",219039,214919,4120,2818,1302
"Lancaster County","Lancaster County, Pennsylvania","050","00","1","2","42071","42","071",422822,413801,9021,4920,4101
"Lawrence County","Lawrence County, Pennsylvania","050","00","1","2","42073","42","073",96246,94641,1605,1303,302
"Lebanon County","Lebanon County, Pennsylvania","050","00","1","2","42075","42","075",113744,111985,1759,1046,713
"Lehigh County","Lehigh County, Pennsylvania","050","00","1","2","42077","42","077",291130,278688,12442,6869,5573
"Luzerne County","Luzerne County, Pennsylvania","050","00","1","2","42079","42","079",328149,322512,5637,3908,1729
"Lycoming County","Lycoming County, Pennsylvania","050","00","1","2","42081","42","081",118710,117576,1134,632,502
"Mc Kean County","Mc Kean County, Pennsylvania","050","00","1","2","42083","42","083",47131,46222,909,498,411
"Mercer County","Mercer County, Pennsylvania","050","00","1","2","42085","42","085",121003,119182,1821,1339,482
"Mifflin County","Mifflin County, Pennsylvania","050","00","1","2","42087","42","087",46197,45983,214,156,58
"Monroe County","Monroe County, Pennsylvania","050","00","1","2","42089","42","089",95709,91694,4015,2473,1542
"Montgomery County","Montgomery County, Pennsylvania","050","00","1","2","42091","42","091",678111,641738,36373,22571,13802
"Montour County","Montour County, Pennsylvania","050","00","1","2","42093","42","093",17735,17453,282,159,123
"Northampton County","Northampton County, Pennsylvania","050","00","1","2","42095","42","095",247105,238376,8729,5095,3634
"Northumberland County","Northumberland County, Pennsylvania","050","00","1","2","42097","42","097",96771,95817,954,742,212
"Perry County","Perry County, Pennsylvania","050","00","1","2","42099","42","099",41172,40954,218,115,103
"Philadelphia County","Philadelphia County, Pennsylvania","050","00","1","2","42101","42","101",1585577,1480763,104814,54884,49930
"Pike County","Pike County, Pennsylvania","050","00","1","2","42103","42","103",27966,26677,1289,965,324
"Potter County","Potter County, Pennsylvania","050","00","1","2","42105","42","105",16717,16573,144,105,39
"Schuylkill County","Schuylkill County, Pennsylvania","050","00","1","2","42107","42","107",152585,150873,1712,1317,395
"Snyder County","Snyder County, Pennsylvania","050","00","1","2","42109","42","109",36680,36440,240,104,136
"Somerset County","Somerset County, Pennsylvania","050","00","1","2","42111","42","111",78218,77747,471,347,124
"Sullivan County","Sullivan County, Pennsylvania","050","00","1","2","42113","42","113",6104,6075,29,27,2
"Susquehanna County","Susquehanna County, Pennsylvania","050","00","1","2","42115","42","115",40380,39898,482,335,147
"Tioga County","Tioga County, Pennsylvania","050","00","1","2","42117","42","117",41126,40738,388,233,155
"Union County","Union County, Pennsylvania","050","00","1","2","42119","42","119",36176,35285,891,356,535
"Venango County","Venango County, Pennsylvania","050","00","1","2","42121","42","121",59381,58888,493,361,132
"Warren County","Warren County, Pennsylvania","050","00","1","2","42123","42","123",45050,44567,483,361,122
"Washington County","Washington County, Pennsylvania","050","00","1","2","42125","42","125",204584,201545,3039,2325,714
"Wayne County","Wayne County, Pennsylvania","050","00","1","2","42127","42","127",39944,38711,1233,927,306
"Westmoreland County","Westmoreland County, Pennsylvania","050","00","1","2","42129","42","129",370321,364678,5643,4291,1352
"Wyoming County","Wyoming County, Pennsylvania","050","00","1","2","42131","42","131",28076,27822,254,173,81
"York County","York County, Pennsylvania","050","00","1","2","42133","42","133",339574,334949,4625,2925,1700
"Bristol County","Bristol County, Rhode Island","050","00","1","1","44001","44","001",48859,43455,5404,2581,2823
"Kent County","Kent County, Rhode Island","050","00","1","1","44003","44","003",161135,154126,7009,4426,2583
"Newport County","Newport County, Rhode Island","050","00","1","1","44005","44","005",87194,83361,3833,2290,1543
"Providence County","Providence County, Rhode Island","050","00","1","1","44007","44","007",596270,521804,74466,30981,43485
"Washington County","Washington County, Rhode Island","050","00","1","1","44009","44","009",110006,105630,4376,2392,1984
"Abbeville County","Abbeville County, South Carolina","050","00","3","5","45001","45","001",23862,23755,107,58,49
"Aiken County","Aiken County, South Carolina","050","00","3","5","45003","45","003",120940,119749,1191,643,548
"Allendale County","Allendale County, South Carolina","050","00","3","5","45005","45","005",11722,11613,109,32,77
"Anderson County","Anderson County, South Carolina","050","00","3","5","45007","45","007",145196,144250,946,525,421
"Bamberg County","Bamberg County, South Carolina","050","00","3","5","45009","45","009",16902,16806,96,67,29
"Barnwell County","Barnwell County, South Carolina","050","00","3","5","45011","45","011",20293,20170,123,52,71
"Beaufort County","Beaufort County, South Carolina","050","00","3","5","45013","45","013",86425,84131,2294,1229,1065
"Berkeley County","Berkeley County, South Carolina","050","00","3","5","45015","45","015",128776,125534,3242,1823,1419
"Calhoun County","Calhoun County, South Carolina","050","00","3","5","45017","45","017",12753,12727,26,16,10
"Charleston County","Charleston County, South Carolina","050","00","3","5","45019","45","019",295039,289207,5832,3074,2758
"Cherokee County","Cherokee County, South Carolina","050","00","3","5","45021","45","021",44506,44323,183,119,64
"Chester County","Chester County, South Carolina","050","00","3","5","45023","45","023",32170,31997,173,111,62
"Chesterfield County","Chesterfield County, South Carolina","050","00","3","5","45025","45","025",38577,38440,137,90,47
"Clarendon County","Clarendon County, South Carolina","050","00","3","5","45027","45","027",28450,28316,134,102,32
"Colleton County","Colleton County, South Carolina","050","00","3","5","45029","45","029",34377,34204,173,71,102
"Darlington County","Darlington County, South Carolina","050","00","3","5","45031","45","031",61851,61628,223,139,84
"Dillon County","Dillon County, South Carolina","050","00","3","5","45033","45","033",29114,28977,137,100,37
"Dorchester County","Dorchester County, South Carolina","050","00","3","5","45035","45","035",83060,81430,1630,981,649
"Edgefield County","Edgefield County, South Carolina","050","00","3","5","45037","45","037",18375,18251,124,56,68
"Fairfield County","Fairfield County, South Carolina","050","00","3","5","45039","45","039",22295,22209,86,63,23
"Florence County","Florence County, South Carolina","050","00","3","5","45041","45","041",114344,113275,1069,618,451
"Georgetown County","Georgetown County, South Carolina","050","00","3","5","45043","45","043",46302,45713,589,351,238
"Greenville County","Greenville County, South Carolina","050","00","3","5","45045","45","045",320167,314288,5879,2712,3167
"Greenwood County","Greenwood County, South Carolina","050","00","3","5","45047","45","047",59567,58949,618,332,286
"Hampton County","Hampton County, South Carolina","050","00","3","5","45049","45","049",18191,18127,64,47,17
"Horry County","Horry County, South Carolina","050","00","3","5","45051","45","051",144053,141055,2998,1861,1137
"Jasper County","Jasper County, South Carolina","050","00","3","5","45053","45","053",15487,15403,84,33,51
"Kershaw County","Kershaw County, South Carolina","050","00","3","5","45055","45","055",43599,43128,471,258,213
"Lancaster County","Lancaster County, South Carolina","050","00","3","5","45057","45","057",54516,54306,210,141,69
"Laurens County","Laurens County, South Carolina","050","00","3","5","45059","45","059",58092,57799,293,156,137
"Lee County","Lee County, South Carolina","050","00","3","5","45061","45","061",18437,18354,83,32,51
"Lexington County","Lexington County, South Carolina","050","00","3","5","45063","45","063",167611,165120,2491,1300,1191
"McCormick County","McCormick County, South Carolina","050","00","3","5","45065","45","065",8868,8842,26,10,16
"Marion County","Marion County, South Carolina","050","00","3","5","45067","45","067",33899,33677,222,139,83
"Marlboro County","Marlboro County, South Carolina","050","00","3","5","45069","45","069",29361,29268,93,63,30
"Newberry County","Newberry County, South Carolina","050","00","3","5","45071","45","071",33172,32997,175,85,90
"Oconee County","Oconee County, South Carolina","050","00","3","5","45073","45","073",57494,56815,679,302,377
"Orangeburg County","Orangeburg County, South Carolina","050","00","3","5","45075","45","075",84803,84160,643,269,374
"Pickens County","Pickens County, South Carolina","050","00","3","5","45077","45","077",93894,92550,1344,394,950
"Richland County","Richland County, South Carolina","050","00","3","5","45079","45","079",285720,277673,8047,3802,4245
"Saluda County","Saluda County, South Carolina","050","00","3","5","45081","45","081",16357,16329,28,28,0
"Spartanburg County","Spartanburg County, South Carolina","050","00","3","5","45083","45","083",226800,223251,3549,1403,2146
"Sumter County","Sumter County, South Carolina","050","00","3","5","45085","45","085",102637,101004,1633,983,650
"Union County","Union County, South Carolina","050","00","3","5","45087","45","087",30337,30284,53,32,21
"Williamsburg County","Williamsburg County, South Carolina","050","00","3","5","45089","45","089",36815,36758,57,40,17
"York County","York County, South Carolina","050","00","3","5","45091","45","091",131497,129897,1600,669,931
"Aurora County","Aurora County, South Dakota","050","00","2","4","46003","46","003",3135,3109,26,18,8
"Beadle County","Beadle County, South Dakota","050","00","2","4","46005","46","005",18253,18106,147,93,54
"Bennett County","Bennett County, South Dakota","050","00","2","4","46007","46","007",3206,3180,26,24,2
"Bon Homme County","Bon Homme County, South Dakota","050","00","2","4","46009","46","009",7089,7020,69,63,6
"Brookings County","Brookings County, South Dakota","050","00","2","4","46011","46","011",25207,24726,481,152,329
"Brown County","Brown County, South Dakota","050","00","2","4","46013","46","013",35580,35272,308,245,63
"Brule County","Brule County, South Dakota","050","00","2","4","46015","46","015",5485,5466,19,14,5
"Buffalo County","Buffalo County, South Dakota","050","00","2","4","46017","46","017",1759,1759,0,0,0
"Butte County","Butte County, South Dakota","050","00","2","4","46019","46","019",7914,7836,78,64,14
"Campbell County","Campbell County, South Dakota","050","00","2","4","46021","46","021",1965,1957,8,6,2
"Charles Mix County","Charles Mix County, South Dakota","050","00","2","4","46023","46","023",9131,9090,41,36,5
"Clark County","Clark County, South Dakota","050","00","2","4","46025","46","025",4403,4375,28,24,4
"Clay County","Clay County, South Dakota","050","00","2","4","46027","46","027",13186,13002,184,60,124
"Codington County","Codington County, South Dakota","050","00","2","4","46029","46","029",22698,22537,161,67,94
"Corson County","Corson County, South Dakota","050","00","2","4","46031","46","031",4195,4179,16,12,4
"Custer County","Custer County, South Dakota","050","00","2","4","46033","46","033",6179,6149,30,17,13
"Davison County","Davison County, South Dakota","050","00","2","4","46035","46","035",17503,17367,136,118,18
"Day County","Day County, South Dakota","050","00","2","4","46037","46","037",6978,6952,26,21,5
"Deuel County","Deuel County, South Dakota","050","00","2","4","46039","46","039",4522,4511,11,6,5
"Dewey County","Dewey County, South Dakota","050","00","2","4","46041","46","041",5523,5509,14,14,0
"Douglas County","Douglas County, South Dakota","050","00","2","4","46043","46","043",3746,3728,18,17,1
"Edmunds County","Edmunds County, South Dakota","050","00","2","4","46045","46","045",4356,4313,43,43,0
"Fall River County","Fall River County, South Dakota","050","00","2","4","46047","46","047",7353,7297,56,44,12
"Faulk County","Faulk County, South Dakota","050","00","2","4","46049","46","049",2744,2670,74,72,2
"Grant County","Grant County, South Dakota","050","00","2","4","46051","46","051",8372,8346,26,19,7
"Gregory County","Gregory County, South Dakota","050","00","2","4","46053","46","053",5359,5330,29,26,3
"Haakon County","Haakon County, South Dakota","050","00","2","4","46055","46","055",2624,2613,11,7,4
"Hamlin County","Hamlin County, South Dakota","050","00","2","4","46057","46","057",4974,4928,46,43,3
"Hand County","Hand County, South Dakota","050","00","2","4","46059","46","059",4272,4197,75,47,28
"Hanson County","Hanson County, South Dakota","050","00","2","4","46061","46","061",2994,2985,9,9,0
"Harding County","Harding County, South Dakota","050","00","2","4","46063","46","063",1669,1657,12,12,0
"Hughes County","Hughes County, South Dakota","050","00","2","4","46065","46","065",14817,14651,166,148,18
"Hutchinson County","Hutchinson County, South Dakota","050","00","2","4","46067","46","067",8262,8196,66,57,9
"Hyde County","Hyde County, South Dakota","050","00","2","4","46069","46","069",1696,1685,11,9,2
"Jackson County","Jackson County, South Dakota","050","00","2","4","46071","46","071",2811,2811,0,0,0
"Jerauld County","Jerauld County, South Dakota","050","00","2","4","46073","46","073",2425,2414,11,9,2
"Jones County","Jones County, South Dakota","050","00","2","4","46075","46","075",1324,1314,10,10,0
"Kingsbury County","Kingsbury County, South Dakota","050","00","2","4","46077","46","077",5925,5890,35,30,5
"Lake County","Lake County, South Dakota","050","00","2","4","46079","46","079",10550,10430,120,64,56
"Lawrence County","Lawrence County, South Dakota","050","00","2","4","46081","46","081",20655,20401,254,164,90
"Lincoln County","Lincoln County, South Dakota","050","00","2","4","46083","46","083",15427,15325,102,89,13
"Lyman County","Lyman County, South Dakota","050","00","2","4","46085","46","085",3638,3635,3,3,0
"McCook County","McCook County, South Dakota","050","00","2","4","46087","46","087",5688,5669,19,19,0
"McPherson County","McPherson County, South Dakota","050","00","2","4","46089","46","089",3228,3156,72,70,2
"Marshall County","Marshall County, South Dakota","050","00","2","4","46091","46","091",4844,4826,18,16,2
"Meade County","Meade County, South Dakota","050","00","2","4","46093","46","093",21878,21468,410,271,139
"Mellette County","Mellette County, South Dakota","050","00","2","4","46095","46","095",2137,2126,11,11,0
"Miner County","Miner County, South Dakota","050","00","2","4","46097","46","097",3272,3257,15,15,0
"Minnehaha County","Minnehaha County, South Dakota","050","00","2","4","46099","46","099",123809,122006,1803,935,868
"Moody County","Moody County, South Dakota","050","00","2","4","46101","46","101",6507,6457,50,32,18
"Pennington County","Pennington County, South Dakota","050","00","2","4","46103","46","103",81343,79645,1698,876,822
"Perkins County","Perkins County, South Dakota","050","00","2","4","46105","46","105",3932,3905,27,21,6
"Potter County","Potter County, South Dakota","050","00","2","4","46107","46","107",3190,3152,38,32,6
"Roberts County","Roberts County, South Dakota","050","00","2","4","46109","46","109",9914,9860,54,48,6
"Sanborn County","Sanborn County, South Dakota","050","00","2","4","46111","46","111",2833,2815,18,17,1
"Shannon County","Shannon County, South Dakota","050","00","2","4","46113","46","113",9902,9872,30,23,7
"Spink County","Spink County, South Dakota","050","00","2","4","46115","46","115",7981,7947,34,19,15
"Stanley County","Stanley County, South Dakota","050","00","2","4","46117","46","117",2453,2446,7,7,0
"Sully County","Sully County, South Dakota","050","00","2","4","46119","46","119",1589,1574,15,13,2
"Todd County","Todd County, South Dakota","050","00","2","4","46121","46","121",8352,8336,16,10,6
"Tripp County","Tripp County, South Dakota","050","00","2","4","46123","46","123",6924,6890,34,22,12
"Turner County","Turner County, South Dakota","050","00","2","4","46125","46","125",8576,8478,98,74,24
"Union County","Union County, South Dakota","050","00","2","4","46127","46","127",10189,10136,53,47,6
"Walworth County","Walworth County, South Dakota","050","00","2","4","46129","46","129",6087,6012,75,65,10
"Yankton County","Yankton County, South Dakota","050","00","2","4","46135","46","135",19252,19115,137,95,42
"Ziebach County","Ziebach County, South Dakota","050","00","2","4","46137","46","137",2220,2207,13,5,8
"Anderson County","Anderson County, Tennessee","050","00","3","6","47001","47","001",68250,67149,1101,535,566
"Bedford County","Bedford County, Tennessee","050","00","3","6","47003","47","003",30411,30073,338,80,258
"Benton County","Benton County, Tennessee","050","00","3","6","47005","47","005",14524,14435,89,53,36
"Bledsoe County","Bledsoe County, Tennessee","050","00","3","6","47007","47","007",9669,9662,7,0,7
"Blount County","Blount County, Tennessee","050","00","3","6","47009","47","009",85969,85128,841,426,415
"Bradley County","Bradley County, Tennessee","050","00","3","6","47011","47","011",73712,72938,774,334,440
"Campbell County","Campbell County, Tennessee","050","00","3","6","47013","47","013",35079,34973,106,43,63
"Cannon County","Cannon County, Tennessee","050","00","3","6","47015","47","015",10467,10422,45,29,16
"Carroll County","Carroll County, Tennessee","050","00","3","6","47017","47","017",27514,27384,130,44,86
"Carter County","Carter County, Tennessee","050","00","3","6","47019","47","019",51505,51126,379,247,132
"Cheatham County","Cheatham County, Tennessee","050","00","3","6","47021","47","021",27140,26979,161,90,71
"Chester County","Chester County, Tennessee","050","00","3","6","47023","47","023",12819,12777,42,13,29
"Claiborne County","Claiborne County, Tennessee","050","00","3","6","47025","47","025",26137,25945,192,40,152
"Clay County","Clay County, Tennessee","050","00","3","6","47027","47","027",7238,7213,25,11,14
"Cocke County","Cocke County, Tennessee","050","00","3","6","47029","47","029",29141,29067,74,61,13
"Coffee County","Coffee County, Tennessee","050","00","3","6","47031","47","031",40339,39930,409,208,201
"Crockett County","Crockett County, Tennessee","050","00","3","6","47033","47","033",13378,13352,26,20,6
"Cumberland County","Cumberland County, Tennessee","050","00","3","6","47035","47","035",34736,34421,315,197,118
"Davidson County","Davidson County, Tennessee","050","00","3","6","47037","47","037",510784,498122,12662,4633,8029
"Decatur County","Decatur County, Tennessee","050","00","3","6","47039","47","039",10472,10443,29,13,16
"DeKalb County","DeKalb County, Tennessee","050","00","3","6","47041","47","041",14360,14285,75,26,49
"Dickson County","Dickson County, Tennessee","050","00","3","6","47043","47","043",35061,34883,178,99,79
"Dyer County","Dyer County, Tennessee","050","00","3","6","47045","47","045",34854,34712,142,72,70
"Fayette County","Fayette County, Tennessee","050","00","3","6","47047","47","047",25559,25476,83,75,8
"Fentress County","Fentress County, Tennessee","050","00","3","6","47049","47","049",14669,14647,22,12,10
"Franklin County","Franklin County, Tennessee","050","00","3","6","47051","47","051",34725,34501,224,78,146
"Gibson County","Gibson County, Tennessee","050","00","3","6","47053","47","053",46315,46144,171,98,73
"Giles County","Giles County, Tennessee","050","00","3","6","47055","47","055",25741,25594,147,93,54
"Grainger County","Grainger County, Tennessee","050","00","3","6","47057","47","057",17095,17061,34,13,21
"Greene County","Greene County, Tennessee","050","00","3","6","47059","47","059",55853,55584,269,108,161
"Grundy County","Grundy County, Tennessee","050","00","3","6","47061","47","061",13362,13337,25,18,7
"Hamblen County","Hamblen County, Tennessee","050","00","3","6","47063","47","063",50480,50171,309,139,170
"Hamilton County","Hamilton County, Tennessee","050","00","3","6","47065","47","065",285536,280994,4542,2364,2178
"Hancock County","Hancock County, Tennessee","050","00","3","6","47067","47","067",6739,6727,12,12,0
"Hardeman County","Hardeman County, Tennessee","050","00","3","6","47069","47","069",23377,23226,151,66,85
"Hardin County","Hardin County, Tennessee","050","00","3","6","47071","47","071",22633,22570,63,31,32
"Hawkins County","Hawkins County, Tennessee","050","00","3","6","47073","47","073",44565,44403,162,67,95
"Haywood County","Haywood County, Tennessee","050","00","3","6","47075","47","075",19437,19348,89,34,55
"Henderson County","Henderson County, Tennessee","050","00","3","6","47077","47","077",21844,21795,49,34,15
"Henry County","Henry County, Tennessee","050","00","3","6","47079","47","079",27888,27741,147,126,21
"Hickman County","Hickman County, Tennessee","050","00","3","6","47081","47","081",16754,16647,107,29,78
"Houston County","Houston County, Tennessee","050","00","3","6","47083","47","083",7018,6998,20,15,5
"Humphreys County","Humphreys County, Tennessee","050","00","3","6","47085","47","085",15795,15705,90,75,15
"Jackson County","Jackson County, Tennessee","050","00","3","6","47087","47","087",9297,9278,19,19,0
"Jefferson County","Jefferson County, Tennessee","050","00","3","6","47089","47","089",33016,32896,120,48,72
"Johnson County","Johnson County, Tennessee","050","00","3","6","47091","47","091",13766,13721,45,27,18
"Knox County","Knox County, Tennessee","050","00","3","6","47093","47","093",335749,329851,5898,2565,3333
"Lake County","Lake County, Tennessee","050","00","3","6","47095","47","095",7129,7124,5,5,0
"Lauderdale County","Lauderdale County, Tennessee","050","00","3","6","47097","47","097",23491,23422,69,51,18
"Lawrence County","Lawrence County, Tennessee","050","00","3","6","47099","47","099",35303,35154,149,66,83
"Lewis County","Lewis County, Tennessee","050","00","3","6","47101","47","101",9247,9206,41,21,20
"Lincoln County","Lincoln County, Tennessee","050","00","3","6","47103","47","103",28157,28075,82,34,48
"Loudon County","Loudon County, Tennessee","050","00","3","6","47105","47","105",31255,31064,191,130,61
"McMinn County","McMinn County, Tennessee","050","00","3","6","47107","47","107",42383,42219,164,68,96
"McNairy County","McNairy County, Tennessee","050","00","3","6","47109","47","109",22422,22380,42,29,13
"Macon County","Macon County, Tennessee","050","00","3","6","47111","47","111",15906,15881,25,12,13
"Madison County","Madison County, Tennessee","050","00","3","6","47113","47","113",77982,77495,487,131,356
"Marion County","Marion County, Tennessee","050","00","3","6","47115","47","115",24860,24770,90,16,74
"Marshall County","Marshall County, Tennessee","050","00","3","6","47117","47","117",21539,21479,60,46,14
"Maury County","Maury County, Tennessee","050","00","3","6","47119","47","119",54812,54555,257,85,172
"Meigs County","Meigs County, Tennessee","050","00","3","6","47121","47","121",8033,8023,10,10,0
"Monroe County","Monroe County, Tennessee","050","00","3","6","47123","47","123",30541,30378,163,62,101
"Montgomery County","Montgomery County, Tennessee","050","00","3","6","47125","47","125",100498,97352,3146,1758,1388
"Moore County","Moore County, Tennessee","050","00","3","6","47127","47","127",4721,4721,0,0,0
"Morgan County","Morgan County, Tennessee","050","00","3","6","47129","47","129",17300,17277,23,19,4
"Obion County","Obion County, Tennessee","050","00","3","6","47131","47","131",31717,31631,86,67,19
"Overton County","Overton County, Tennessee","050","00","3","6","47133","47","133",17636,17607,29,11,18
"Perry County","Perry County, Tennessee","050","00","3","6","47135","47","135",6612,6567,45,12,33
"Pickett County","Pickett County, Tennessee","050","00","3","6","47137","47","137",4548,4535,13,13,0
"Polk County","Polk County, Tennessee","050","00","3","6","47139","47","139",13643,13547,96,61,35
"Putnam County","Putnam County, Tennessee","050","00","3","6","47141","47","141",51373,50485,888,309,579
"Rhea County","Rhea County, Tennessee","050","00","3","6","47143","47","143",24344,24156,188,127,61
"Roane County","Roane County, Tennessee","050","00","3","6","47145","47","145",47227,46961,266,190,76
"Robertson County","Robertson County, Tennessee","050","00","3","6","47147","47","147",41494,41341,153,104,49
"Rutherford County","Rutherford County, Tennessee","050","00","3","6","47149","47","149",118570,116488,2082,809,1273
"Scott County","Scott County, Tennessee","050","00","3","6","47151","47","151",18358,18326,32,17,15
"Sequatchie County","Sequatchie County, Tennessee","050","00","3","6","47153","47","153",8863,8855,8,8,0
"Sevier County","Sevier County, Tennessee","050","00","3","6","47155","47","155",51043,50659,384,236,148
"Shelby County","Shelby County, Tennessee","050","00","3","6","47157","47","157",826330,813287,13043,6078,6965
"Smith County","Smith County, Tennessee","050","00","3","6","47159","47","159",14143,14099,44,19,25
"Stewart County","Stewart County, Tennessee","050","00","3","6","47161","47","161",9479,9410,69,39,30
"Sullivan County","Sullivan County, Tennessee","050","00","3","6","47163","47","163",143596,142641,955,487,468
"Sumner County","Sumner County, Tennessee","050","00","3","6","47165","47","165",103281,102260,1021,510,511
"Tipton County","Tipton County, Tennessee","050","00","3","6","47167","47","167",37568,37381,187,67,120
"Trousdale County","Trousdale County, Tennessee","050","00","3","6","47169","47","169",5920,5920,0,0,0
"Unicoi County","Unicoi County, Tennessee","050","00","3","6","47171","47","171",16549,16479,70,44,26
"Union County","Union County, Tennessee","050","00","3","6","47173","47","173",13694,13664,30,19,11
"Van Buren County","Van Buren County, Tennessee","050","00","3","6","47175","47","175",4846,4844,2,2,0
"Warren County","Warren County, Tennessee","050","00","3","6","47177","47","177",32992,32741,251,128,123
"Washington County","Washington County, Tennessee","050","00","3","6","47179","47","179",92315,91282,1033,433,600
"Wayne County","Wayne County, Tennessee","050","00","3","6","47181","47","181",13935,13922,13,12,1
"Weakley County","Weakley County, Tennessee","050","00","3","6","47183","47","183",31972,31582,390,102,288
"White County","White County, Tennessee","050","00","3","6","47185","47","185",20090,20051,39,0,39
"Williamson County","Williamson County, Tennessee","050","00","3","6","47187","47","187",81021,79775,1246,510,736
"Wilson County","Wilson County, Tennessee","050","00","3","6","47189","47","189",67675,67166,509,214,295
"Anderson County","Anderson County, Texas","050","00","3","7","48001","48","001",48024,46458,1566,536,1030
"Andrews County","Andrews County, Texas","050","00","3","7","48003","48","003",14338,12717,1621,511,1110
"Angelina County","Angelina County, Texas","050","00","3","7","48005","48","005",69884,67020,2864,882,1982
"Aransas County","Aransas County, Texas","050","00","3","7","48007","48","007",17892,17000,892,416,476
"Archer County","Archer County, Texas","050","00","3","7","48009","48","009",7973,7875,98,51,47
"Armstrong County","Armstrong County, Texas","050","00","3","7","48011","48","011",2021,1978,43,21,22
"Atascosa County","Atascosa County, Texas","050","00","3","7","48013","48","013",30533,29488,1045,414,631
"Austin County","Austin County, Texas","050","00","3","7","48015","48","015",19832,18944,888,347,541
"Bailey County","Bailey County, Texas","050","00","3","7","48017","48","017",7064,6421,643,153,490
"Bandera County","Bandera County, Texas","050","00","3","7","48019","48","019",10562,10371,191,100,91
"Bastrop County","Bastrop County, Texas","050","00","3","7","48021","48","021",38263,36584,1679,495,1184
"Baylor County","Baylor County, Texas","050","00","3","7","48023","48","023",4385,4340,45,17,28
"Bee County","Bee County, Texas","050","00","3","7","48025","48","025",25135,24447,688,379,309
"Bell County","Bell County, Texas","050","00","3","7","48027","48","027",191088,180853,10235,5826,4409
"Bexar County","Bexar County, Texas","050","00","3","7","48029","48","029",1185394,1085740,99654,44061,55593
"Blanco County","Blanco County, Texas","050","00","3","7","48031","48","031",5972,5724,248,85,163
"Borden County","Borden County, Texas","050","00","3","7","48033","48","033",799,774,25,2,23
"Bosque County","Bosque County, Texas","050","00","3","7","48035","48","035",15125,14548,577,243,334
"Bowie County","Bowie County, Texas","050","00","3","7","48037","48","037",81665,80730,935,403,532
"Brazoria County","Brazoria County, Texas","050","00","3","7","48039","48","039",191707,182393,9314,3407,5907
"Brazos County","Brazos County, Texas","050","00","3","7","48041","48","041",121862,112906,8956,2279,6677
"Brewster County","Brewster County, Texas","050","00","3","7","48043","48","043",8681,8204,477,133,344
"Briscoe County","Briscoe County, Texas","050","00","3","7","48045","48","045",1971,1884,87,4,83
"Brooks County","Brooks County, Texas","050","00","3","7","48047","48","047",8204,7902,302,123,179
"Brown County","Brown County, Texas","050","00","3","7","48049","48","049",34371,33539,832,278,554
"Burleson County","Burleson County, Texas","050","00","3","7","48051","48","051",13625,13342,283,155,128
"Burnet County","Burnet County, Texas","050","00","3","7","48053","48","053",22677,21951,726,316,410
"Caldwell County","Caldwell County, Texas","050","00","3","7","48055","48","055",26392,25451,941,354,587
"Calhoun County","Calhoun County, Texas","050","00","3","7","48057","48","057",19053,17923,1130,345,785
"Callahan County","Callahan County, Texas","050","00","3","7","48059","48","059",11859,11737,122,60,62
"Cameron County","Cameron County, Texas","050","00","3","7","48061","48","061",260120,202519,57601,20006,37595
"Camp County","Camp County, Texas","050","00","3","7","48063","48","063",9904,9607,297,134,163
"Carson County","Carson County, Texas","050","00","3","7","48065","48","065",6576,6456,120,75,45
"Cass County","Cass County, Texas","050","00","3","7","48067","48","067",29982,29771,211,126,85
"Castro County","Castro County, Texas","050","00","3","7","48069","48","069",9070,8174,896,422,474
"Chambers County","Chambers County, Texas","050","00","3","7","48071","48","071",20088,19343,745,196,549
"Cherokee County","Cherokee County, Texas","050","00","3","7","48073","48","073",41049,39440,1609,449,1160
"Childress County","Childress County, Texas","050","00","3","7","48075","48","075",5953,5773,180,80,100
"Clay County","Clay County, Texas","050","00","3","7","48077","48","077",10024,9928,96,60,36
"Cochran County","Cochran County, Texas","050","00","3","7","48079","48","079",4377,4111,266,128,138
"Coke County","Coke County, Texas","050","00","3","7","48081","48","081",3424,3360,64,16,48
"Coleman County","Coleman County, Texas","050","00","3","7","48083","48","083",9710,9512,198,76,122
"Collin County","Collin County, Texas","050","00","3","7","48085","48","085",264036,248425,15611,5619,9992
"Collingsworth County","Collingsworth County, Texas","050","00","3","7","48087","48","087",3573,3447,126,85,41
"Colorado County","Colorado County, Texas","050","00","3","7","48089","48","089",18383,17783,600,217,383
"Comal County","Comal County, Texas","050","00","3","7","48091","48","091",51832,49737,2095,881,1214
"Comanche County","Comanche County, Texas","050","00","3","7","48093","48","093",13381,12796,585,153,432
"Concho County","Concho County, Texas","050","00","3","7","48095","48","095",3044,2574,470,43,427
"Cooke County","Cooke County, Texas","050","00","3","7","48097","48","097",30777,29978,799,243,556
"Coryell County","Coryell County, Texas","050","00","3","7","48099","48","099",64213,61005,3208,1586,1622
"Cottle County","Cottle County, Texas","050","00","3","7","48101","48","101",2247,2193,54,15,39
"Crane County","Crane County, Texas","050","00","3","7","48103","48","103",4652,4325,327,122,205
"Crockett County","Crockett County, Texas","050","00","3","7","48105","48","105",4078,3594,484,102,382
"Crosby County","Crosby County, Texas","050","00","3","7","48107","48","107",7304,7141,163,96,67
"Culberson County","Culberson County, Texas","050","00","3","7","48109","48","109",3407,2904,503,221,282
"Dallam County","Dallam County, Texas","050","00","3","7","48111","48","111",5461,5332,129,51,78
"Dallas County","Dallas County, Texas","050","00","3","7","48113","48","113",1852810,1656482,196328,57433,138895
"Dawson County","Dawson County, Texas","050","00","3","7","48115","48","115",14349,13859,490,234,256
"Deaf Smith County","Deaf Smith County, Texas","050","00","3","7","48117","48","117",19153,17571,1582,485,1097
"Delta County","Delta County, Texas","050","00","3","7","48119","48","119",4857,4854,3,0,3
"Denton County","Denton County, Texas","050","00","3","7","48121","48","121",273525,258831,14694,4767,9927
"DeWitt County","DeWitt County, Texas","050","00","3","7","48123","48","123",18840,18620,220,147,73
"Dickens County","Dickens County, Texas","050","00","3","7","48125","48","125",2571,2500,71,26,45
"Dimmit County","Dimmit County, Texas","050","00","3","7","48127","48","127",10433,9450,983,448,535
"Donley County","Donley County, Texas","050","00","3","7","48129","48","129",3696,3677,19,9,10
"Duval County","Duval County, Texas","050","00","3","7","48131","48","131",12918,12432,486,205,281
"Eastland County","Eastland County, Texas","050","00","3","7","48133","48","133",18488,18109,379,173,206
"Ector County","Ector County, Texas","050","00","3","7","48135","48","135",118934,110009,8925,3336,5589
"Edwards County","Edwards County, Texas","050","00","3","7","48137","48","137",2266,1975,291,140,151
"Ellis County","Ellis County, Texas","050","00","3","7","48139","48","139",85167,82274,2893,1061,1832
"El Paso County","El Paso County, Texas","050","00","3","7","48141","48","141",591610,449994,141616,47153,94463
"Erath County","Erath County, Texas","050","00","3","7","48143","48","143",27991,26908,1083,423,660
"Falls County","Falls County, Texas","050","00","3","7","48145","48","145",17712,17183,529,273,256
"Fannin County","Fannin County, Texas","050","00","3","7","48147","48","147",24804,24399,405,262,143
"Fayette County","Fayette County, Texas","050","00","3","7","48149","48","149",20095,19364,731,298,433
"Fisher County","Fisher County, Texas","050","00","3","7","48151","48","151",4842,4677,165,115,50
"Floyd County","Floyd County, Texas","050","00","3","7","48153","48","153",8497,8011,486,168,318
"Foard County","Foard County, Texas","050","00","3","7","48155","48","155",1794,1772,22,12,10
"Fort Bend County","Fort Bend County, Texas","050","00","3","7","48157","48","157",225421,200430,24991,10034,14957
"Franklin County","Franklin County, Texas","050","00","3","7","48159","48","159",7802,7559,243,43,200
"Freestone County","Freestone County, Texas","050","00","3","7","48161","48","161",15818,15513,305,136,169
"Frio County","Frio County, Texas","050","00","3","7","48163","48","163",13472,12654,818,375,443
"Gaines County","Gaines County, Texas","050","00","3","7","48165","48","165",14123,11740,2383,569,1814
"Galveston County","Galveston County, Texas","050","00","3","7","48167","48","167",217399,206654,10745,4627,6118
"Garza County","Garza County, Texas","050","00","3","7","48169","48","169",5143,4931,212,130,82
"Gillespie County","Gillespie County, Texas","050","00","3","7","48171","48","171",17204,16462,742,370,372
"Glasscock County","Glasscock County, Texas","050","00","3","7","48173","48","173",1447,1222,225,44,181
"Goliad County","Goliad County, Texas","050","00","3","7","48175","48","175",5980,5925,55,28,27
"Gonzales County","Gonzales County, Texas","050","00","3","7","48177","48","177",17205,16239,966,382,584
"Gray County","Gray County, Texas","050","00","3","7","48179","48","179",23967,23252,715,264,451
"Grayson County","Grayson County, Texas","050","00","3","7","48181","48","181",95021,93305,1716,628,1088
"Gregg County","Gregg County, Texas","050","00","3","7","48183","48","183",104948,102761,2187,833,1354
"Grimes County","Grimes County, Texas","050","00","3","7","48185","48","185",18828,17961,867,361,506
"Guadalupe County","Guadalupe County, Texas","050","00","3","7","48187","48","187",64873,62274,2599,1276,1323
"Hale County","Hale County, Texas","050","00","3","7","48189","48","189",34671,32394,2277,877,1400
"Hall County","Hall County, Texas","050","00","3","7","48191","48","191",3905,3740,165,61,104
"Hamilton County","Hamilton County, Texas","050","00","3","7","48193","48","193",7733,7594,139,35,104
"Hansford County","Hansford County, Texas","050","00","3","7","48195","48","195",5848,5326,522,163,359
"Hardeman County","Hardeman County, Texas","050","00","3","7","48197","48","197",5283,5109,174,35,139
"Hardin County","Hardin County, Texas","050","00","3","7","48199","48","199",41320,41101,219,141,78
"Harris County","Harris County, Texas","050","00","3","7","48201","48","201",2818199,2414225,403974,121601,282373
"Harrison County","Harrison County, Texas","050","00","3","7","48203","48","203",57483,56726,757,397,360
"Hartley County","Hartley County, Texas","050","00","3","7","48205","48","205",3634,3569,65,21,44
"Haskell County","Haskell County, Texas","050","00","3","7","48207","48","207",6820,6633,187,72,115
"Hays County","Hays County, Texas","050","00","3","7","48209","48","209",65614,63009,2605,1120,1485
"Hemphill County","Hemphill County, Texas","050","00","3","7","48211","48","211",3720,3534,186,27,159
"Henderson County","Henderson County, Texas","050","00","3","7","48213","48","213",58543,57494,1049,326,723
"Hidalgo County","Hidalgo County, Texas","050","00","3","7","48215","48","215",383545,288831,94714,29902,64812
"Hill County","Hill County, Texas","050","00","3","7","48217","48","217",27146,26497,649,200,449
"Hockley County","Hockley County, Texas","050","00","3","7","48219","48","219",24199,23424,775,425,350
"Hood County","Hood County, Texas","050","00","3","7","48221","48","221",28981,28372,609,335,274
"Hopkins County","Hopkins County, Texas","050","00","3","7","48223","48","223",28833,27980,853,221,632
"Houston County","Houston County, Texas","050","00","3","7","48225","48","225",21375,20971,404,187,217
"Howard County","Howard County, Texas","050","00","3","7","48227","48","227",32343,31143,1200,615,585
"Hudspeth County","Hudspeth County, Texas","050","00","3","7","48229","48","229",2915,2199,716,243,473
"Hunt County","Hunt County, Texas","050","00","3","7","48231","48","231",64343,62898,1445,573,872
"Hutchinson County","Hutchinson County, Texas","050","00","3","7","48233","48","233",25689,24698,991,425,566
"Irion County","Irion County, Texas","050","00","3","7","48235","48","235",1629,1551,78,49,29
"Jack County","Jack County, Texas","050","00","3","7","48237","48","237",6981,6877,104,77,27
"Jackson County","Jackson County, Texas","050","00","3","7","48239","48","239",13039,12717,322,146,176
"Jasper County","Jasper County, Texas","050","00","3","7","48241","48","241",31102,30817,285,114,171
"Jeff Davis County","Jeff Davis County, Texas","050","00","3","7","48243","48","243",1946,1826,120,57,63
"Jefferson County","Jefferson County, Texas","050","00","3","7","48245","48","245",239397,230564,8833,3239,5594
"Jim Hogg County","Jim Hogg County, Texas","050","00","3","7","48247","48","247",5109,4847,262,107,155
"Jim Wells County","Jim Wells County, Texas","050","00","3","7","48249","48","249",37679,36469,1210,592,618
"Johnson County","Johnson County, Texas","050","00","3","7","48251","48","251",97165,94392,2773,1170,1603
"Jones County","Jones County, Texas","050","00","3","7","48253","48","253",16490,16227,263,149,114
"Karnes County","Karnes County, Texas","050","00","3","7","48255","48","255",12455,12230,225,62,163
"Kaufman County","Kaufman County, Texas","050","00","3","7","48257","48","257",52220,50649,1571,603,968
"Kendall County","Kendall County, Texas","050","00","3","7","48259","48","259",14589,13850,739,233,506
"Kenedy County","Kenedy County, Texas","050","00","3","7","48261","48","261",460,411,49,10,39
"Kent County","Kent County, Texas","050","00","3","7","48263","48","263",1010,974,36,9,27
"Kerr County","Kerr County, Texas","050","00","3","7","48265","48","265",36304,34664,1640,741,899
"Kimble County","Kimble County, Texas","050","00","3","7","48267","48","267",4122,3860,262,137,125
"King County","King County, Texas","050","00","3","7","48269","48","269",354,337,17,6,11
"Kinney County","Kinney County, Texas","050","00","3","7","48271","48","271",3119,2719,400,162,238
"Kleberg County","Kleberg County, Texas","050","00","3","7","48273","48","273",30274,28781,1493,613,880
"Knox County","Knox County, Texas","050","00","3","7","48275","48","275",4837,4643,194,110,84
"Lamar County","Lamar County, Texas","050","00","3","7","48277","48","277",43949,43473,476,129,347
"Lamb County","Lamb County, Texas","050","00","3","7","48279","48","279",15072,14279,793,359,434
"Lampasas County","Lampasas County, Texas","050","00","3","7","48281","48","281",13521,12970,551,293,258
"La Salle County","La Salle County, Texas","050","00","3","7","48283","48","283",5254,5003,251,110,141
"Lavaca County","Lavaca County, Texas","050","00","3","7","48285","48","285",18690,18404,286,140,146
"Lee County","Lee County, Texas","050","00","3","7","48287","48","287",12854,12333,521,157,364
"Leon County","Leon County, Texas","050","00","3","7","48289","48","289",12665,12510,155,45,110
"Liberty County","Liberty County, Texas","050","00","3","7","48291","48","291",52726,51421,1305,504,801
"Limestone County","Limestone County, Texas","050","00","3","7","48293","48","293",20946,20464,482,271,211
"Lipscomb County","Lipscomb County, Texas","050","00","3","7","48295","48","295",3143,2958,185,74,111
"Live Oak County","Live Oak County, Texas","050","00","3","7","48297","48","297",9556,9348,208,117,91
"Llano County","Llano County, Texas","050","00","3","7","48299","48","299",11631,11465,166,77,89
"Loving County","Loving County, Texas","050","00","3","7","48301","48","301",107,103,4,4,0
"Lubbock County","Lubbock County, Texas","050","00","3","7","48303","48","303",222636,215570,7066,2858,4208
"Lynn County","Lynn County, Texas","050","00","3","7","48305","48","305",6758,6573,185,71,114
"McCulloch County","McCulloch County, Texas","050","00","3","7","48307","48","307",8778,8342,436,221,215
"McLennan County","McLennan County, Texas","050","00","3","7","48309","48","309",189123,182385,6738,2740,3998
"McMullen County","McMullen County, Texas","050","00","3","7","48311","48","311",817,800,17,0,17
"Madison County","Madison County, Texas","050","00","3","7","48313","48","313",10931,10668,263,91,172
"Marion County","Marion County, Texas","050","00","3","7","48315","48","315",9984,9914,70,27,43
"Martin County","Martin County, Texas","050","00","3","7","48317","48","317",4956,4561,395,89,306
"Mason County","Mason County, Texas","050","00","3","7","48319","48","319",3423,3247,176,75,101
"Matagorda County","Matagorda County, Texas","050","00","3","7","48321","48","321",36928,35146,1782,735,1047
"Maverick County","Maverick County, Texas","050","00","3","7","48323","48","323",36378,23320,13058,4272,8786
"Medina County","Medina County, Texas","050","00","3","7","48325","48","325",27312,26376,936,383,553
"Menard County","Menard County, Texas","050","00","3","7","48327","48","327",2252,2171,81,58,23
"Midland County","Midland County, Texas","050","00","3","7","48329","48","329",106611,100090,6521,3154,3367
"Milam County","Milam County, Texas","050","00","3","7","48331","48","331",22946,22400,546,231,315
"Mills County","Mills County, Texas","050","00","3","7","48333","48","333",4531,4368,163,63,100
"Mitchell County","Mitchell County, Texas","050","00","3","7","48335","48","335",8016,7885,131,47,84
"Montague County","Montague County, Texas","050","00","3","7","48337","48","337",17274,17022,252,78,174
"Montgomery County","Montgomery County, Texas","050","00","3","7","48339","48","339",182201,174180,8021,2646,5375
"Moore County","Moore County, Texas","050","00","3","7","48341","48","341",17865,15532,2333,394,1939
"Morris County","Morris County, Texas","050","00","3","7","48343","48","343",13200,13041,159,90,69
"Motley County","Motley County, Texas","050","00","3","7","48345","48","345",1532,1497,35,10,25
"Nacogdoches County","Nacogdoches County, Texas","050","00","3","7","48347","48","347",54753,52999,1754,540,1214
"Navarro County","Navarro County, Texas","050","00","3","7","48349","48","349",39926,38696,1230,492,738
"Newton County","Newton County, Texas","050","00","3","7","48351","48","351",13569,13469,100,33,67
"Nolan County","Nolan County, Texas","050","00","3","7","48353","48","353",16594,16174,420,232,188
"Nueces County","Nueces County, Texas","050","00","3","7","48355","48","355",291145,276217,14928,6910,8018
"Ochiltree County","Ochiltree County, Texas","050","00","3","7","48357","48","357",9128,8347,781,255,526
"Oldham County","Oldham County, Texas","050","00","3","7","48359","48","359",2278,2229,49,12,37
"Orange County","Orange County, Texas","050","00","3","7","48361","48","361",80509,79410,1099,602,497
"Palo Pinto County","Palo Pinto County, Texas","050","00","3","7","48363","48","363",25055,24242,813,454,359
"Panola County","Panola County, Texas","050","00","3","7","48365","48","365",22035,21788,247,116,131
"Parker County","Parker County, Texas","050","00","3","7","48367","48","367",64785,63653,1132,511,621
"Parmer County","Parmer County, Texas","050","00","3","7","48369","48","369",9863,8535,1328,364,964
"Pecos County","Pecos County, Texas","050","00","3","7","48371","48","371",14675,12880,1795,672,1123
"Polk County","Polk County, Texas","050","00","3","7","48373","48","373",30687,29939,748,264,484
"Potter County","Potter County, Texas","050","00","3","7","48375","48","375",97874,92103,5771,1679,4092
"Presidio County","Presidio County, Texas","050","00","3","7","48377","48","377",6637,5015,1622,299,1323
"Rains County","Rains County, Texas","050","00","3","7","48379","48","379",6715,6631,84,58,26
"Randall County","Randall County, Texas","050","00","3","7","48381","48","381",89673,88387,1286,620,666
"Reagan County","Reagan County, Texas","050","00","3","7","48383","48","383",4514,3942,572,175,397
"Real County","Real County, Texas","050","00","3","7","48385","48","385",2412,2192,220,55,165
"Red River County","Red River County, Texas","050","00","3","7","48387","48","387",14317,14168,149,57,92
"Reeves County","Reeves County, Texas","050","00","3","7","48389","48","389",15852,13557,2295,849,1446
"Refugio County","Refugio County, Texas","050","00","3","7","48391","48","391",7976,7849,127,64,63
"Roberts County","Roberts County, Texas","050","00","3","7","48393","48","393",1025,1017,8,8,0
"Robertson County","Robertson County, Texas","050","00","3","7","48395","48","395",15511,15166,345,136,209
"Rockwall County","Rockwall County, Texas","050","00","3","7","48397","48","397",25604,24673,931,346,585
"Runnels County","Runnels County, Texas","050","00","3","7","48399","48","399",11294,10993,301,193,108
"Rusk County","Rusk County, Texas","050","00","3","7","48401","48","401",43735,42806,929,383,546
"Sabine County","Sabine County, Texas","050","00","3","7","48403","48","403",9586,9543,43,27,16
"San Augustine County","San Augustine County, Texas","050","00","3","7","48405","48","405",7999,7964,35,15,20
"San Jacinto County","San Jacinto County, Texas","050","00","3","7","48407","48","407",16372,16152,220,62,158
"San Patricio County","San Patricio County, Texas","050","00","3","7","48409","48","409",58749,57209,1540,774,766
"San Saba County","San Saba County, Texas","050","00","3","7","48411","48","411",5401,5170,231,116,115
"Schleicher County","Schleicher County, Texas","050","00","3","7","48413","48","413",2990,2697,293,92,201
"Scurry County","Scurry County, Texas","050","00","3","7","48415","48","415",18634,18052,582,182,400
"Shackelford County","Shackelford County, Texas","050","00","3","7","48417","48","417",3316,3232,84,44,40
"Shelby County","Shelby County, Texas","050","00","3","7","48419","48","419",22034,21720,314,134,180
"Sherman County","Sherman County, Texas","050","00","3","7","48421","48","421",2858,2556,302,133,169
"Smith County","Smith County, Texas","050","00","3","7","48423","48","423",151309,145828,5481,1658,3823
"Somervell County","Somervell County, Texas","050","00","3","7","48425","48","425",5360,5050,310,68,242
"Starr County","Starr County, Texas","050","00","3","7","48427","48","427",40518,26436,14082,2990,11092
"Stephens County","Stephens County, Texas","050","00","3","7","48429","48","429",9010,8865,145,63,82
"Sterling County","Sterling County, Texas","050","00","3","7","48431","48","431",1438,1362,76,25,51
"Stonewall County","Stonewall County, Texas","050","00","3","7","48433","48","433",2013,1954,59,31,28
"Sutton County","Sutton County, Texas","050","00","3","7","48435","48","435",4135,3714,421,125,296
"Swisher County","Swisher County, Texas","050","00","3","7","48437","48","437",8133,7717,416,288,128
"Tarrant County","Tarrant County, Texas","050","00","3","7","48439","48","439",1170103,1090740,79363,28198,51165
"Taylor County","Taylor County, Texas","050","00","3","7","48441","48","441",119655,115280,4375,1876,2499
"Terrell County","Terrell County, Texas","050","00","3","7","48443","48","443",1410,1309,101,58,43
"Terry County","Terry County, Texas","050","00","3","7","48445","48","445",13218,12721,497,192,305
"Throckmorton County","Throckmorton County, Texas","050","00","3","7","48447","48","447",1880,1824,56,21,35
"Titus County","Titus County, Texas","050","00","3","7","48449","48","449",24009,22354,1655,580,1075
"Tom Green County","Tom Green County, Texas","050","00","3","7","48451","48","451",98458,93487,4971,2299,2672
"Travis County","Travis County, Texas","050","00","3","7","48453","48","453",576407,531327,45080,14499,30581
"Trinity County","Trinity County, Texas","050","00","3","7","48455","48","455",11445,11331,114,21,93
"Tyler County","Tyler County, Texas","050","00","3","7","48457","48","457",16646,16485,161,59,102
"Upshur County","Upshur County, Texas","050","00","3","7","48459","48","459",31370,30929,441,96,345
"Upton County","Upton County, Texas","050","00","3","7","48461","48","461",4447,4030,417,222,195
"Uvalde County","Uvalde County, Texas","050","00","3","7","48463","48","463",23340,20716,2624,945,1679
"Val Verde County","Val Verde County, Texas","050","00","3","7","48465","48","465",38721,30876,7845,2559,5286
"Van Zandt County","Van Zandt County, Texas","050","00","3","7","48467","48","467",37944,37238,706,136,570
"Victoria County","Victoria County, Texas","050","00","3","7","48469","48","469",74361,72154,2207,998,1209
"Walker County","Walker County, Texas","050","00","3","7","48471","48","471",50917,48791,2126,539,1587
"Waller County","Waller County, Texas","050","00","3","7","48473","48","473",23390,22105,1285,346,939
"Ward County","Ward County, Texas","050","00","3","7","48475","48","475",13115,12143,972,424,548
"Washington County","Washington County, Texas","050","00","3","7","48477","48","477",26154,25599,555,142,413
"Webb County","Webb County, Texas","050","00","3","7","48479","48","479",133239,99934,33305,10229,23076
"Wharton County","Wharton County, Texas","050","00","3","7","48481","48","481",39955,38637,1318,580,738
"Wheeler County","Wheeler County, Texas","050","00","3","7","48483","48","483",5879,5773,106,53,53
"Wichita County","Wichita County, Texas","050","00","3","7","48485","48","485",122378,117953,4425,1966,2459
"Wilbarger County","Wilbarger County, Texas","050","00","3","7","48487","48","487",15121,14794,327,171,156
"Willacy County","Willacy County, Texas","050","00","3","7","48489","48","489",17705,14867,2838,1258,1580
"Williamson County","Williamson County, Texas","050","00","3","7","48491","48","491",139551,133702,5849,2660,3189
"Wilson County","Wilson County, Texas","050","00","3","7","48493","48","493",22650,22054,596,337,259
"Winkler County","Winkler County, Texas","050","00","3","7","48495","48","495",8626,7493,1133,385,748
"Wise County","Wise County, Texas","050","00","3","7","48497","48","497",34679,33446,1233,437,796
"Wood County","Wood County, Texas","050","00","3","7","48499","48","499",29380,29039,341,126,215
"Yoakum County","Yoakum County, Texas","050","00","3","7","48501","48","501",8786,7753,1033,363,670
"Young County","Young County, Texas","050","00","3","7","48503","48","503",18126,17831,295,123,172
"Zapata County","Zapata County, Texas","050","00","3","7","48505","48","505",9279,7499,1780,598,1182
"Zavala County","Zavala County, Texas","050","00","3","7","48507","48","507",12162,10566,1596,621,975
"Beaver County","Beaver County, Utah","050","00","4","8","49001","49","001",4765,4685,80,48,32
"Box Elder County","Box Elder County, Utah","050","00","4","8","49003","49","003",36485,35911,574,246,328
"Cache County","Cache County, Utah","050","00","4","8","49005","49","005",70183,67008,3175,814,2361
"Carbon County","Carbon County, Utah","050","00","4","8","49007","49","007",20228,19836,392,238,154
"Daggett County","Daggett County, Utah","050","00","4","8","49009","49","009",690,690,0,0,0
"Davis County","Davis County, Utah","050","00","4","8","49011","49","011",187941,183365,4576,2584,1992
"Duchesne County","Duchesne County, Utah","050","00","4","8","49013","49","013",12645,12487,158,68,90
"Emery County","Emery County, Utah","050","00","4","8","49015","49","015",10332,10234,98,41,57
"Garfield County","Garfield County, Utah","050","00","4","8","49017","49","017",3980,3946,34,25,9
"Grand County","Grand County, Utah","050","00","4","8","49019","49","019",6620,6537,83,51,32
"Iron County","Iron County, Utah","050","00","4","8","49021","49","021",20789,20615,174,79,95
"Juab County","Juab County, Utah","050","00","4","8","49023","49","023",5817,5785,32,18,14
"Kane County","Kane County, Utah","050","00","4","8","49025","49","025",5169,5100,69,26,43
"Millard County","Millard County, Utah","050","00","4","8","49027","49","027",11333,11078,255,38,217
"Morgan County","Morgan County, Utah","050","00","4","8","49029","49","029",5528,5486,42,25,17
"Piute County","Piute County, Utah","050","00","4","8","49031","49","031",1277,1274,3,2,1
"Rich County","Rich County, Utah","050","00","4","8","49033","49","033",1725,1708,17,3,14
"Salt Lake County","Salt Lake County, Utah","050","00","4","8","49035","49","035",725956,692942,33014,15347,17667
"San Juan County","San Juan County, Utah","050","00","4","8","49037","49","037",12621,12479,142,40,102
"Sanpete County","Sanpete County, Utah","050","00","4","8","49039","49","039",16259,15688,571,115,456
"Sevier County","Sevier County, Utah","050","00","4","8","49041","49","041",15431,15269,162,76,86
"Summit County","Summit County, Utah","050","00","4","8","49043","49","043",15518,15169,349,165,184
"Tooele County","Tooele County, Utah","050","00","4","8","49045","49","045",26601,25720,881,371,510
"Uintah County","Uintah County, Utah","050","00","4","8","49047","49","047",22211,21967,244,85,159
"Utah County","Utah County, Utah","050","00","4","8","49049","49","049",263590,255289,8301,2544,5757
"Wasatch County","Wasatch County, Utah","050","00","4","8","49051","49","051",10089,10020,69,36,33
"Washington County","Washington County, Utah","050","00","4","8","49053","49","053",48560,47656,904,544,360
"Wayne County","Wayne County, Utah","050","00","4","8","49055","49","055",2177,2161,16,0,16
"Weber County","Weber County, Utah","050","00","4","8","49057","49","057",158330,154145,4185,2212,1973
"Addison County","Addison County, Vermont","050","00","1","1","50001","50","001",32953,31988,965,582,383
"Bennington County","Bennington County, Vermont","050","00","1","1","50003","50","003",35845,34784,1061,715,346
"Caledonia County","Caledonia County, Vermont","050","00","1","1","50005","50","005",27846,27122,724,519,205
"Chittenden County","Chittenden County, Vermont","050","00","1","1","50007","50","007",131761,126723,5038,2707,2331
"Essex County","Essex County, Vermont","050","00","1","1","50009","50","009",6405,6036,369,229,140
"Franklin County","Franklin County, Vermont","050","00","1","1","50011","50","011",39980,38371,1609,1111,498
"Grand Isle County","Grand Isle County, Vermont","050","00","1","1","50013","50","013",5318,5124,194,98,96
"Lamoille County","Lamoille County, Vermont","050","00","1","1","50015","50","015",19735,19159,576,305,271
"Orange County","Orange County, Vermont","050","00","1","1","50017","50","017",26149,25663,486,266,220
"Orleans County","Orleans County, Vermont","050","00","1","1","50019","50","019",24053,22770,1283,776,507
"Rutland County","Rutland County, Vermont","050","00","1","1","50021","50","021",62142,60846,1296,815,481
"Washington County","Washington County, Vermont","050","00","1","1","50023","50","023",54928,53297,1631,1070,561
"Windham County","Windham County, Vermont","050","00","1","1","50025","50","025",41588,40502,1086,648,438
"Windsor County","Windsor County, Vermont","050","00","1","1","50027","50","027",54055,52829,1226,805,421
"Accomack County","Accomack County, Virginia","050","00","3","5","51001","51","001",31703,31298,405,190,215
"Albemarle County","Albemarle County, Virginia","050","00","3","5","51003","51","003",68040,65157,2883,1247,1636
"Alleghany County","Alleghany County, Virginia","050","00","3","5","51005","51","005",13176,13054,122,58,64
"Amelia County","Amelia County, Virginia","050","00","3","5","51007","51","007",8787,8744,43,27,16
"Amherst County","Amherst County, Virginia","050","00","3","5","51009","51","009",28578,28341,237,119,118
"Appomattox County","Appomattox County, Virginia","050","00","3","5","51011","51","011",12298,12256,42,28,14
"Arlington County","Arlington County, Virginia","050","00","3","5","51013","51","013",170936,134420,36516,9181,27335
"Augusta County","Augusta County, Virginia","050","00","3","5","51015","51","015",54677,54361,316,151,165
"Bath County","Bath County, Virginia","050","00","3","5","51017","51","017",4799,4744,55,30,25
"Bedford County","Bedford County, Virginia","050","00","3","5","51019","51","019",45656,45179,477,226,251
"Bland County","Bland County, Virginia","050","00","3","5","51021","51","021",6514,6482,32,11,21
"Botetourt County","Botetourt County, Virginia","050","00","3","5","51023","51","023",24992,24797,195,119,76
"Brunswick County","Brunswick County, Virginia","050","00","3","5","51025","51","025",15987,15886,101,46,55
"Buchanan County","Buchanan County, Virginia","050","00","3","5","51027","51","027",31333,31177,156,37,119
"Buckingham County","Buckingham County, Virginia","050","00","3","5","51029","51","029",12873,12801,72,48,24
"Campbell County","Campbell County, Virginia","050","00","3","5","51031","51","031",47572,47218,354,157,197
"Caroline County","Caroline County, Virginia","050","00","3","5","51033","51","033",19217,19055,162,118,44
"Carroll County","Carroll County, Virginia","050","00","3","5","51035","51","035",26594,26443,151,98,53
"Charles City County","Charles City County, Virginia","050","00","3","5","51036","51","036",6282,6256,26,17,9
"Charlotte County","Charlotte County, Virginia","050","00","3","5","51037","51","037",11688,11648,40,16,24
"Chesterfield County","Chesterfield County, Virginia","050","00","3","5","51041","51","041",209274,203030,6244,3169,3075
"Clarke County","Clarke County, Virginia","050","00","3","5","51043","51","043",12101,11913,188,108,80
"Craig County","Craig County, Virginia","050","00","3","5","51045","51","045",4372,4354,18,11,7
"Culpeper County","Culpeper County, Virginia","050","00","3","5","51047","51","047",27791,27290,501,167,334
"Cumberland County","Cumberland County, Virginia","050","00","3","5","51049","51","049",7825,7771,54,30,24
"Dickenson County","Dickenson County, Virginia","050","00","3","5","51051","51","051",17620,17575,45,34,11
"Dinwiddie County","Dinwiddie County, Virginia","050","00","3","5","51053","51","053",20960,20808,152,81,71
"Essex County","Essex County, Virginia","050","00","3","5","51057","51","057",8689,8602,87,53,34
"Fairfax County","Fairfax County, Virginia","050","00","3","5","51059","51","059",818584,691078,127506,47111,80395
"Fauquier County","Fauquier County, Virginia","050","00","3","5","51061","51","061",48741,47622,1119,613,506
"Floyd County","Floyd County, Virginia","050","00","3","5","51063","51","063",12005,11960,45,29,16
"Fluvanna County","Fluvanna County, Virginia","050","00","3","5","51065","51","065",12429,12221,208,117,91
"Franklin County","Franklin County, Virginia","050","00","3","5","51067","51","067",39549,39310,239,154,85
"Frederick County","Frederick County, Virginia","050","00","3","5","51069","51","069",45723,45113,610,280,330
"Giles County","Giles County, Virginia","050","00","3","5","51071","51","071",16366,16315,51,43,8
"Gloucester County","Gloucester County, Virginia","050","00","3","5","51073","51","073",30131,29667,464,238,226
"Goochland County","Goochland County, Virginia","050","00","3","5","51075","51","075",14163,13952,211,112,99
"Grayson County","Grayson County, Virginia","050","00","3","5","51077","51","077",16278,16205,73,65,8
"Greene County","Greene County, Virginia","050","00","3","5","51079","51","079",10297,10216,81,47,34
"Greensville County","Greensville County, Virginia","050","00","3","5","51081","51","081",8853,8800,53,30,23
"Halifax County","Halifax County, Virginia","050","00","3","5","51083","51","083",29033,28912,121,53,68
"Hanover County","Hanover County, Virginia","050","00","3","5","51085","51","085",63306,62467,839,446,393
"Henrico County","Henrico County, Virginia","050","00","3","5","51087","51","087",217881,209958,7923,3701,4222
"Henry County","Henry County, Virginia","050","00","3","5","51089","51","089",56942,56623,319,198,121
"Highland County","Highland County, Virginia","050","00","3","5","51091","51","091",2635,2631,4,2,2
"Isle of Wight County","Isle of Wight County, Virginia","050","00","3","5","51093","51","093",25053,24840,213,155,58
"James City County","James City County, Virginia","050","00","3","5","51095","51","095",34859,33648,1211,700,511
"King and Queen County","King and Queen County, Virginia","050","00","3","5","51097","51","097",6289,6273,16,13,3
"King George County","King George County, Virginia","050","00","3","5","51099","51","099",13527,13234,293,159,134
"King William County","King William County, Virginia","050","00","3","5","51101","51","101",10913,10830,83,20,63
"Lancaster County","Lancaster County, Virginia","050","00","3","5","51103","51","103",10896,10734,162,72,90
"Lee County","Lee County, Virginia","050","00","3","5","51105","51","105",24496,24455,41,24,17
"Loudoun County","Loudoun County, Virginia","050","00","3","5","51107","51","107",86129,81249,4880,2186,2694
"Louisa County","Louisa County, Virginia","050","00","3","5","51109","51","109",20325,20165,160,113,47
"Lunenburg County","Lunenburg County, Virginia","050","00","3","5","51111","51","111",11419,11351,68,21,47
"Madison County","Madison County, Virginia","050","00","3","5","51113","51","113",11949,11812,137,76,61
"Mathews County","Mathews County, Virginia","050","00","3","5","51115","51","115",8348,8280,68,68,0
"Mecklenburg County","Mecklenburg County, Virginia","050","00","3","5","51117","51","117",29241,29061,180,112,68
"Middlesex County","Middlesex County, Virginia","050","00","3","5","51119","51","119",8653,8570,83,57,26
"Montgomery County","Montgomery County, Virginia","050","00","3","5","51121","51","121",73913,69851,4062,1015,3047
"Nelson County","Nelson County, Virginia","050","00","3","5","51125","51","125",12778,12654,124,40,84
"New Kent County","New Kent County, Virginia","050","00","3","5","51127","51","127",10445,10336,109,71,38
"Northampton County","Northampton County, Virginia","050","00","3","5","51131","51","131",13061,12827,234,119,115
"Northumberland County","Northumberland County, Virginia","050","00","3","5","51133","51","133",10524,10452,72,72,0
"Nottoway County","Nottoway County, Virginia","050","00","3","5","51135","51","135",14993,14897,96,59,37
"Orange County","Orange County, Virginia","050","00","3","5","51137","51","137",21421,21094,327,161,166
"Page County","Page County, Virginia","050","00","3","5","51139","51","139",21690,21466,224,156,68
"Patrick County","Patrick County, Virginia","050","00","3","5","51141","51","141",17473,17400,73,38,35
"Pittsylvania County","Pittsylvania County, Virginia","050","00","3","5","51143","51","143",55655,55516,139,101,38
"Powhatan County","Powhatan County, Virginia","050","00","3","5","51145","51","145",15328,15153,175,93,82
"Prince Edward County","Prince Edward County, Virginia","050","00","3","5","51147","51","147",17320,17089,231,131,100
"Prince George County","Prince George County, Virginia","050","00","3","5","51149","51","149",27394,26250,1144,607,537
"Prince William County","Prince William County, Virginia","050","00","3","5","51153","51","153",215686,202239,13447,6067,7380
"Pulaski County","Pulaski County, Virginia","050","00","3","5","51155","51","155",34496,34344,152,106,46
"Rappahannock County","Rappahannock County, Virginia","050","00","3","5","51157","51","157",6622,6504,118,65,53
"Richmond County","Richmond County, Virginia","050","00","3","5","51159","51","159",7273,7223,50,13,37
"Roanoke County","Roanoke County, Virginia","050","00","3","5","51161","51","161",79332,77862,1470,777,693
"Rockbridge County","Rockbridge County, Virginia","050","00","3","5","51163","51","163",18350,18157,193,114,79
"Rockingham County","Rockingham County, Virginia","050","00","3","5","51165","51","165",57482,56806,676,389,287
"Russell County","Russell County, Virginia","050","00","3","5","51167","51","167",28667,28622,45,33,12
"Scott County","Scott County, Virginia","050","00","3","5","51169","51","169",23204,23163,41,22,19
"Shenandoah County","Shenandoah County, Virginia","050","00","3","5","51171","51","171",31636,31282,354,199,155
"Smyth County","Smyth County, Virginia","050","00","3","5","51173","51","173",32370,32305,65,30,35
"Southampton County","Southampton County, Virginia","050","00","3","5","51175","51","175",17550,17472,78,78,0
"Spotsylvania County","Spotsylvania County, Virginia","050","00","3","5","51177","51","177",57403,56377,1026,650,376
"Stafford County","Stafford County, Virginia","050","00","3","5","51179","51","179",61236,59403,1833,1222,611
"Surry County","Surry County, Virginia","050","00","3","5","51181","51","181",6145,6125,20,14,6
"Sussex County","Sussex County, Virginia","050","00","3","5","51183","51","183",10248,10218,30,17,13
"Tazewell County","Tazewell County, Virginia","050","00","3","5","51185","51","185",45960,45749,211,116,95
"Warren County","Warren County, Virginia","050","00","3","5","51187","51","187",26142,25788,354,180,174
"Washington County","Washington County, Virginia","050","00","3","5","51191","51","191",45887,45625,262,143,119
"Westmoreland County","Westmoreland County, Virginia","050","00","3","5","51193","51","193",15480,15267,213,136,77
"Wise County","Wise County, Virginia","050","00","3","5","51195","51","195",39573,39372,201,77,124
"Wythe County","Wythe County, Virginia","050","00","3","5","51197","51","197",25466,25260,206,121,85
"York County","York County, Virginia","050","00","3","5","51199","51","199",42422,41030,1392,826,566
"Alexandria city","Alexandria city, Virginia","050","00","3","5","51510","51","510",111183,93185,17998,4711,13287
"Bedford city","Bedford city, Virginia","050","00","3","5","51515","51","515",6073,5968,105,46,59
"Bristol city","Bristol city, Virginia","050","00","3","5","51520","51","520",18426,18274,152,74,78
"Buena Vista city","Buena Vista city, Virginia","050","00","3","5","51530","51","530",6406,6352,54,12,42
"Charlottesville city","Charlottesville city, Virginia","050","00","3","5","51540","51","540",40341,38889,1452,542,910
"Chesapeake city","Chesapeake city, Virginia","050","00","3","5","51550","51","550",151976,149324,2652,1548,1104
"Clifton Forge city","Clifton Forge city, Virginia","050","00","3","5","51560","51","560",4679,4672,7,7,0
"Colonial Heights city","Colonial Heights city, Virginia","050","00","3","5","51570","51","570",16064,15394,670,411,259
"Covington city","Covington city, Virginia","050","00","3","5","51580","51","580",6991,6944,47,25,22
"Danville city","Danville city, Virginia","050","00","3","5","51590","51","590",53056,52697,359,257,102
"Emporia city","Emporia city, Virginia","050","00","3","5","51595","51","595",5306,5244,62,26,36
"Fairfax city","Fairfax city, Virginia","050","00","3","5","51600","51","600",19622,16722,2900,994,1906
"Falls Church city","Falls Church city, Virginia","050","00","3","5","51610","51","610",9578,8570,1008,371,637
"Franklin city","Franklin city, Virginia","050","00","3","5","51620","51","620",7864,7825,39,39,0
"Fredericksburg city","Fredericksburg city, Virginia","050","00","3","5","51630","51","630",19027,18477,550,294,256
"Galax city","Galax city, Virginia","050","00","3","5","51640","51","640",6670,6624,46,17,29
"Hampton city","Hampton city, Virginia","050","00","3","5","51650","51","650",133793,129935,3858,2191,1667
"Harrisonburg city","Harrisonburg city, Virginia","050","00","3","5","51660","51","660",30707,29967,740,227,513
"Hopewell city","Hopewell city, Virginia","050","00","3","5","51670","51","670",23101,22503,598,341,257
"Lexington city","Lexington city, Virginia","050","00","3","5","51678","51","678",6959,6810,149,71,78
"Lynchburg city","Lynchburg city, Virginia","050","00","3","5","51680","51","680",66049,64941,1108,384,724
"Manassas city","Manassas city, Virginia","050","00","3","5","51683","51","683",27957,25828,2129,810,1319
"Manassas Park city","Manassas Park city, Virginia","050","00","3","5","51685","51","685",6734,6366,368,160,208
"Martinsville city","Martinsville city, Virginia","050","00","3","5","51690","51","690",16162,16020,142,54,88
"Newport News city","Newport News city, Virginia","050","00","3","5","51700","51","700",170045,163113,6932,3408,3524
"Norfolk city","Norfolk city, Virginia","050","00","3","5","51710","51","710",261229,251463,9766,4963,4803
"Norton city","Norton city, Virginia","050","00","3","5","51720","51","720",4247,4199,48,30,18
"Petersburg city","Petersburg city, Virginia","050","00","3","5","51730","51","730",38386,37679,707,412,295
"Poquoson city","Poquoson city, Virginia","050","00","3","5","51735","51","735",11005,10774,231,163,68
"Portsmouth city","Portsmouth city, Virginia","050","00","3","5","51740","51","740",103907,102519,1388,822,566
"Radford city","Radford city, Virginia","050","00","3","5","51750","51","750",15940,15502,438,171,267
"Richmond city","Richmond city, Virginia","050","00","3","5","51760","51","760",203056,199336,3720,1542,2178
"Roanoke city","Roanoke city, Virginia","050","00","3","5","51770","51","770",96397,94882,1515,732,783
"Salem city","Salem city, Virginia","050","00","3","5","51775","51","775",23756,23355,401,225,176
"South Boston city","South Boston city, Virginia","050","00","3","5","51780","51","780",6997,6940,57,33,24
"Staunton city","Staunton city, Virginia","050","00","3","5","51790","51","790",24461,24094,367,181,186
"Suffolk city","Suffolk city, Virginia","050","00","3","5","51800","51","800",52141,51708,433,240,193
"Virginia Beach city","Virginia Beach city, Virginia","050","00","3","5","51810","51","810",393069,372552,20517,11894,8623
"Waynesboro city","Waynesboro city, Virginia","050","00","3","5","51820","51","820",18549,18149,400,175,225
"Williamsburg city","Williamsburg city, Virginia","050","00","3","5","51830","51","830",11530,10972,558,209,349
"Winchester city","Winchester city, Virginia","050","00","3","5","51840","51","840",21947,21391,556,191,365
"Adams County","Adams County, Washington","050","00","4","9","53001","53","001",13603,11859,1744,449,1295
"Asotin County","Asotin County, Washington","050","00","4","9","53003","53","003",17605,17393,212,142,70
"Benton County","Benton County, Washington","050","00","4","9","53005","53","005",112560,106902,5658,2273,3385
"Chelan County","Chelan County, Washington","050","00","4","9","53007","53","007",52250,48614,3636,917,2719
"Clallam County","Clallam County, Washington","050","00","4","9","53009","53","009",56464,54175,2289,1468,821
"Clark County","Clark County, Washington","050","00","4","9","53011","53","011",238053,229376,8677,4682,3995
"Columbia County","Columbia County, Washington","050","00","4","9","53013","53","013",4024,3680,344,103,241
"Cowlitz County","Cowlitz County, Washington","050","00","4","9","53015","53","015",82119,79683,2436,1308,1128
"Douglas County","Douglas County, Washington","050","00","4","9","53017","53","017",26205,23940,2265,574,1691
"Ferry County","Ferry County, Washington","050","00","4","9","53019","53","019",6295,6154,141,84,57
"Franklin County","Franklin County, Washington","050","00","4","9","53021","53","021",37473,31286,6187,1441,4746
"Garfield County","Garfield County, Washington","050","00","4","9","53023","53","023",2248,2213,35,19,16
"Grant County","Grant County, Washington","050","00","4","9","53025","53","025",54758,50207,4551,1199,3352
"Grays Harbor County","Grays Harbor County, Washington","050","00","4","9","53027","53","027",64175,62462,1713,1056,657
"Island County","Island County, Washington","050","00","4","9","53029","53","029",60195,56785,3410,1830,1580
"Jefferson County","Jefferson County, Washington","050","00","4","9","53031","53","031",20146,19547,599,328,271
"King County","King County, Washington","050","00","4","9","53033","53","033",1507319,1366708,140611,64986,75625
"Kitsap County","Kitsap County, Washington","050","00","4","9","53035","53","035",189731,181996,7735,4946,2789
"Kittitas County","Kittitas County, Washington","050","00","4","9","53037","53","037",26725,25704,1021,588,433
"Klickitat County","Klickitat County, Washington","050","00","4","9","53039","53","039",16616,15890,726,292,434
"Lewis County","Lewis County, Washington","050","00","4","9","53041","53","041",59358,58081,1277,714,563
"Lincoln County","Lincoln County, Washington","050","00","4","9","53043","53","043",8864,8747,117,80,37
"Mason County","Mason County, Washington","050","00","4","9","53045","53","045",38341,37239,1102,668,434
"Okanogan County","Okanogan County, Washington","050","00","4","9","53047","53","047",33350,30957,2393,675,1718
"Pacific County","Pacific County, Washington","050","00","4","9","53049","53","049",18882,18053,829,308,521
"Pend Oreille County","Pend Oreille County, Washington","050","00","4","9","53051","53","051",8915,8764,151,105,46
"Pierce County","Pierce County, Washington","050","00","4","9","53053","53","053",586203,550609,35594,19559,16035
"San Juan County","San Juan County, Washington","050","00","4","9","53055","53","055",10035,9492,543,357,186
"Skagit County","Skagit County, Washington","050","00","4","9","53057","53","057",79555,75671,3884,2053,1831
"Skamania County","Skamania County, Washington","050","00","4","9","53059","53","059",8289,8144,145,78,67
"Snohomish County","Snohomish County, Washington","050","00","4","9","53061","53","061",465642,439865,25777,12769,13008
"Spokane County","Spokane County, Washington","050","00","4","9","53063","53","063",361364,349551,11813,6664,5149
"Stevens County","Stevens County, Washington","050","00","4","9","53065","53","065",30948,30415,533,370,163
"Thurston County","Thurston County, Washington","050","00","4","9","53067","53","067",161238,153432,7806,4332,3474
"Wahkiakum County","Wahkiakum County, Washington","050","00","4","9","53069","53","069",3327,3196,131,102,29
"Walla Walla County","Walla Walla County, Washington","050","00","4","9","53071","53","071",48439,45377,3062,893,2169
"Whatcom County","Whatcom County, Washington","050","00","4","9","53073","53","073",127780,117847,9933,4433,5500
"Whitman County","Whitman County, Washington","050","00","4","9","53075","53","075",38775,36111,2664,569,2095
"Yakima County","Yakima County, Washington","050","00","4","9","53077","53","077",188823,168423,20400,5842,14558
"Barbour County","Barbour County, West Virginia","050","00","3","5","54001","54","001",15699,15618,81,31,50
"Berkeley County","Berkeley County, West Virginia","050","00","3","5","54003","54","003",59253,58662,591,291,300
"Boone County","Boone County, West Virginia","050","00","3","5","54005","54","005",25870,25816,54,37,17
"Braxton County","Braxton County, West Virginia","050","00","3","5","54007","54","007",12998,12970,28,22,6
"Brooke County","Brooke County, West Virginia","050","00","3","5","54009","54","009",26992,26577,415,287,128
"Cabell County","Cabell County, West Virginia","050","00","3","5","54011","54","011",96827,95656,1171,591,580
"Calhoun County","Calhoun County, West Virginia","050","00","3","5","54013","54","013",7885,7843,42,36,6
"Clay County","Clay County, West Virginia","050","00","3","5","54015","54","015",9983,9977,6,3,3
"Doddridge County","Doddridge County, West Virginia","050","00","3","5","54017","54","017",6994,6936,58,22,36
"Fayette County","Fayette County, West Virginia","050","00","3","5","54019","54","019",47952,47549,403,269,134
"Gilmer County","Gilmer County, West Virginia","050","00","3","5","54021","54","021",7669,7613,56,32,24
"Grant County","Grant County, West Virginia","050","00","3","5","54023","54","023",10428,10398,30,14,16
"Greenbrier County","Greenbrier County, West Virginia","050","00","3","5","54025","54","025",34693,34427,266,133,133
"Hampshire County","Hampshire County, West Virginia","050","00","3","5","54027","54","027",16498,16393,105,34,71
"Hancock County","Hancock County, West Virginia","050","00","3","5","54029","54","029",35233,34444,789,600,189
"Hardy County","Hardy County, West Virginia","050","00","3","5","54031","54","031",10977,10941,36,28,8
"Harrison County","Harrison County, West Virginia","050","00","3","5","54033","54","033",69371,68770,601,491,110
"Jackson County","Jackson County, West Virginia","050","00","3","5","54035","54","035",25938,25854,84,42,42
"Jefferson County","Jefferson County, West Virginia","050","00","3","5","54037","54","037",35926,35329,597,353,244
"Kanawha County","Kanawha County, West Virginia","050","00","3","5","54039","54","039",207619,205535,2084,1258,826
"Lewis County","Lewis County, West Virginia","050","00","3","5","54041","54","041",17223,17165,58,51,7
"Lincoln County","Lincoln County, West Virginia","050","00","3","5","54043","54","043",21382,21337,45,25,20
"Logan County","Logan County, West Virginia","050","00","3","5","54045","54","045",43032,42727,305,255,50
"McDowell County","McDowell County, West Virginia","050","00","3","5","54047","54","047",35233,35090,143,107,36
"Marion County","Marion County, West Virginia","050","00","3","5","54049","54","049",57249,56685,564,367,197
"Marshall County","Marshall County, West Virginia","050","00","3","5","54051","54","051",37356,37075,281,217,64
"Mason County","Mason County, West Virginia","050","00","3","5","54053","54","053",25178,25083,95,39,56
"Mercer County","Mercer County, West Virginia","050","00","3","5","54055","54","055",64980,64464,516,368,148
"Mineral County","Mineral County, West Virginia","050","00","3","5","54057","54","057",26697,26571,126,59,67
"Mingo County","Mingo County, West Virginia","050","00","3","5","54059","54","059",33739,33646,93,64,29
"Monongalia County","Monongalia County, West Virginia","050","00","3","5","54061","54","061",75509,73105,2404,781,1623
"Monroe County","Monroe County, West Virginia","050","00","3","5","54063","54","063",12406,12380,26,17,9
"Morgan County","Morgan County, West Virginia","050","00","3","5","54065","54","065",12128,12018,110,95,15
"Nicholas County","Nicholas County, West Virginia","050","00","3","5","54067","54","067",26775,26663,112,89,23
"Ohio County","Ohio County, West Virginia","050","00","3","5","54069","54","069",50871,50064,807,549,258
"Pendleton County","Pendleton County, West Virginia","050","00","3","5","54071","54","071",8054,8034,20,6,14
"Pleasants County","Pleasants County, West Virginia","050","00","3","5","54073","54","073",7546,7518,28,26,2
"Pocahontas County","Pocahontas County, West Virginia","050","00","3","5","54075","54","075",9008,8984,24,16,8
"Preston County","Preston County, West Virginia","050","00","3","5","54077","54","077",29037,28917,120,91,29
"Putnam County","Putnam County, West Virginia","050","00","3","5","54079","54","079",42835,42608,227,109,118
"Raleigh County","Raleigh County, West Virginia","050","00","3","5","54081","54","081",76819,76169,650,491,159
"Randolph County","Randolph County, West Virginia","050","00","3","5","54083","54","083",27803,27654,149,58,91
"Ritchie County","Ritchie County, West Virginia","050","00","3","5","54085","54","085",10233,10201,32,30,2
"Roane County","Roane County, West Virginia","050","00","3","5","54087","54","087",15120,15078,42,29,13
"Summers County","Summers County, West Virginia","050","00","3","5","54089","54","089",14204,14093,111,42,69
"Taylor County","Taylor County, West Virginia","050","00","3","5","54091","54","091",15144,15092,52,45,7
"Tucker County","Tucker County, West Virginia","050","00","3","5","54093","54","093",7728,7714,14,14,0
"Tyler County","Tyler County, West Virginia","050","00","3","5","54095","54","095",9796,9759,37,29,8
"Upshur County","Upshur County, West Virginia","050","00","3","5","54097","54","097",22867,22768,99,53,46
"Wayne County","Wayne County, West Virginia","050","00","3","5","54099","54","099",41636,41543,93,51,42
"Webster County","Webster County, West Virginia","050","00","3","5","54101","54","101",10729,10716,13,13,0
"Wetzel County","Wetzel County, West Virginia","050","00","3","5","54103","54","103",19258,19220,38,19,19
"Wirt County","Wirt County, West Virginia","050","00","3","5","54105","54","105",5192,5184,8,8,0
"Wood County","Wood County, West Virginia","050","00","3","5","54107","54","107",86915,86200,715,454,261
"Wyoming County","Wyoming County, West Virginia","050","00","3","5","54109","54","109",28990,28932,58,35,23
"Adams County","Adams County, Wisconsin","050","00","2","3","55001","55","001",15682,15173,509,232,277
"Ashland County","Ashland County, Wisconsin","050","00","2","3","55003","55","003",16307,16166,141,118,23
"Barron County","Barron County, Wisconsin","050","00","2","3","55005","55","005",40750,40321,429,331,98
"Bayfield County","Bayfield County, Wisconsin","050","00","2","3","55007","55","007",14008,13834,174,142,32
"Brown County","Brown County, Wisconsin","050","00","2","3","55009","55","009",194594,191602,2992,922,2070
"Buffalo County","Buffalo County, Wisconsin","050","00","2","3","55011","55","011",13584,13507,77,60,17
"Burnett County","Burnett County, Wisconsin","050","00","2","3","55013","55","013",13084,12980,104,88,16
"Calumet County","Calumet County, Wisconsin","050","00","2","3","55015","55","015",34291,34031,260,137,123
"Chippewa County","Chippewa County, Wisconsin","050","00","2","3","55017","55","017",52360,52013,347,240,107
"Clark County","Clark County, Wisconsin","050","00","2","3","55019","55","019",31647,31284,363,287,76
"Columbia County","Columbia County, Wisconsin","050","00","2","3","55021","55","021",45088,44578,510,360,150
"Crawford County","Crawford County, Wisconsin","050","00","2","3","55023","55","023",15940,15827,113,87,26
"Dane County","Dane County, Wisconsin","050","00","2","3","55025","55","025",367085,353090,13995,4433,9562
"Dodge County","Dodge County, Wisconsin","050","00","2","3","55027","55","027",76559,75758,801,631,170
"Door County","Door County, Wisconsin","050","00","2","3","55029","55","029",25690,25403,287,186,101
"Douglas County","Douglas County, Wisconsin","050","00","2","3","55031","55","031",41758,41159,599,429,170
"Dunn County","Dunn County, Wisconsin","050","00","2","3","55033","55","033",35909,35238,671,229,442
"Eau Claire County","Eau Claire County, Wisconsin","050","00","2","3","55035","55","035",85183,83003,2180,557,1623
"Florence County","Florence County, Wisconsin","050","00","2","3","55037","55","037",4590,4547,43,34,9
"Fond du Lac County","Fond du Lac County, Wisconsin","050","00","2","3","55039","55","039",90083,88989,1094,636,458
"Forest County","Forest County, Wisconsin","050","00","2","3","55041","55","041",8776,8710,66,51,15
"Grant County","Grant County, Wisconsin","050","00","2","3","55043","55","043",49264,48950,314,185,129
"Green County","Green County, Wisconsin","050","00","2","3","55045","55","045",30339,29970,369,270,99
"Green Lake County","Green Lake County, Wisconsin","050","00","2","3","55047","55","047",18651,18429,222,147,75
"Iowa County","Iowa County, Wisconsin","050","00","2","3","55049","55","049",20150,20055,95,61,34
"Iron County","Iron County, Wisconsin","050","00","2","3","55051","55","051",6153,6003,150,130,20
"Jackson County","Jackson County, Wisconsin","050","00","2","3","55053","55","053",16588,16421,167,99,68
"Jefferson County","Jefferson County, Wisconsin","050","00","2","3","55055","55","055",67783,66744,1039,575,464
"Juneau County","Juneau County, Wisconsin","050","00","2","3","55057","55","057",21650,21339,311,246,65
"Kenosha County","Kenosha County, Wisconsin","050","00","2","3","55059","55","059",128181,122638,5543,3484,2059
"Kewaunee County","Kewaunee County, Wisconsin","050","00","2","3","55061","55","061",18878,18819,59,35,24
"La Crosse County","La Crosse County, Wisconsin","050","00","2","3","55063","55","063",97904,95273,2631,714,1917
"Lafayette County","Lafayette County, Wisconsin","050","00","2","3","55065","55","065",16076,15995,81,52,29
"Langlade County","Langlade County, Wisconsin","050","00","2","3","55067","55","067",19505,19358,147,129,18
"Lincoln County","Lincoln County, Wisconsin","050","00","2","3","55069","55","069",26993,26656,337,247,90
"Manitowoc County","Manitowoc County, Wisconsin","050","00","2","3","55071","55","071",80421,79196,1225,444,781
"Marathon County","Marathon County, Wisconsin","050","00","2","3","55073","55","073",115400,112813,2587,853,1734
"Marinette County","Marinette County, Wisconsin","050","00","2","3","55075","55","075",40548,40026,522,394,128
"Marquette County","Marquette County, Wisconsin","050","00","2","3","55077","55","077",12321,12156,165,121,44
"Menominee County","Menominee County, Wisconsin","050","00","2","3","55078","55","078",3890,3885,5,4,1
"Milwaukee County","Milwaukee County, Wisconsin","050","00","2","3","55079","55","079",959275,916500,42775,22847,19928
"Monroe County","Monroe County, Wisconsin","050","00","2","3","55081","55","081",36633,36274,359,266,93
"Oconto County","Oconto County, Wisconsin","050","00","2","3","55083","55","083",30226,30010,216,176,40
"Oneida County","Oneida County, Wisconsin","050","00","2","3","55085","55","085",31679,31142,537,408,129
"Outagamie County","Outagamie County, Wisconsin","050","00","2","3","55087","55","087",140510,138034,2476,1219,1257
"Ozaukee County","Ozaukee County, Wisconsin","050","00","2","3","55089","55","089",72831,71316,1515,995,520
"Pepin County","Pepin County, Wisconsin","050","00","2","3","55091","55","091",7107,7073,34,20,14
"Pierce County","Pierce County, Wisconsin","050","00","2","3","55093","55","093",32765,32391,374,198,176
"Polk County","Polk County, Wisconsin","050","00","2","3","55095","55","095",34773,34486,287,219,68
"Portage County","Portage County, Wisconsin","050","00","2","3","55097","55","097",61405,60360,1045,289,756
"Price County","Price County, Wisconsin","050","00","2","3","55099","55","099",15600,15422,178,158,20
"Racine County","Racine County, Wisconsin","050","00","2","3","55101","55","101",175034,169579,5455,3176,2279
"Richland County","Richland County, Wisconsin","050","00","2","3","55103","55","103",17521,17426,95,53,42
"Rock County","Rock County, Wisconsin","050","00","2","3","55105","55","105",139510,137264,2246,1277,969
"Rusk County","Rusk County, Wisconsin","050","00","2","3","55107","55","107",15079,14860,219,160,59
"St. Croix County","St. Croix County, Wisconsin","050","00","2","3","55109","55","109",50251,49804,447,299,148
"Sauk County","Sauk County, Wisconsin","050","00","2","3","55111","55","111",46975,46505,470,364,106
"Sawyer County","Sawyer County, Wisconsin","050","00","2","3","55113","55","113",14181,14017,164,144,20
"Shawano County","Shawano County, Wisconsin","050","00","2","3","55115","55","115",37157,36941,216,151,65
"Sheboygan County","Sheboygan County, Wisconsin","050","00","2","3","55117","55","117",103877,100855,3022,1371,1651
"Taylor County","Taylor County, Wisconsin","050","00","2","3","55119","55","119",18901,18783,118,107,11
"Trempealeau County","Trempealeau County, Wisconsin","050","00","2","3","55121","55","121",25263,25127,136,97,39
"Vernon County","Vernon County, Wisconsin","050","00","2","3","55123","55","123",25617,25465,152,119,33
"Vilas County","Vilas County, Wisconsin","050","00","2","3","55125","55","125",17707,17369,338,302,36
"Walworth County","Walworth County, Wisconsin","050","00","2","3","55127","55","127",75000,72392,2608,1650,958
"Washburn County","Washburn County, Wisconsin","050","00","2","3","55129","55","129",13772,13624,148,128,20
"Washington County","Washington County, Wisconsin","050","00","2","3","55131","55","131",95328,93881,1447,1057,390
"Waukesha County","Waukesha County, Wisconsin","050","00","2","3","55133","55","133",304715,296409,8306,5581,2725
"Waupaca County","Waupaca County, Wisconsin","050","00","2","3","55135","55","135",46104,45691,413,318,95
"Waushara County","Waushara County, Wisconsin","050","00","2","3","55137","55","137",19385,19064,321,226,95
"Winnebago County","Winnebago County, Wisconsin","050","00","2","3","55139","55","139",140320,137483,2837,1329,1508
"Wood County","Wood County, Wisconsin","050","00","2","3","55141","55","141",73605,72736,869,527,342
"Albany County","Albany County, Wyoming","050","00","4","8","56001","56","001",30797,29772,1025,277,748
"Big Horn County","Big Horn County, Wyoming","050","00","4","8","56003","56","003",10525,10354,171,110,61
"Campbell County","Campbell County, Wyoming","050","00","4","8","56005","56","005",29370,29118,252,164,88
"Carbon County","Carbon County, Wyoming","050","00","4","8","56007","56","007",16659,16250,409,166,243
"Converse County","Converse County, Wyoming","050","00","4","8","56009","56","009",11128,10957,171,67,104
"Crook County","Crook County, Wyoming","050","00","4","8","56011","56","011",5294,5267,27,22,5
"Fremont County","Fremont County, Wyoming","050","00","4","8","56013","56","013",33662,33315,347,153,194
"Goshen County","Goshen County, Wyoming","050","00","4","8","56015","56","015",12373,12081,292,196,96
"Hot Springs County","Hot Springs County, Wyoming","050","00","4","8","56017","56","017",4809,4780,29,20,9
"Johnson County","Johnson County, Wyoming","050","00","4","8","56019","56","019",6145,6030,115,93,22
"Laramie County","Laramie County, Wyoming","050","00","4","8","56021","56","021",73142,71470,1672,997,675
"Lincoln County","Lincoln County, Wyoming","050","00","4","8","56023","56","023",12625,12505,120,59,61
"Natrona County","Natrona County, Wyoming","050","00","4","8","56025","56","025",61226,60350,876,450,426
"Niobrara County","Niobrara County, Wyoming","050","00","4","8","56027","56","027",2499,2465,34,8,26
"Park County","Park County, Wyoming","050","00","4","8","56029","56","029",23178,22894,284,156,128
"Platte County","Platte County, Wyoming","050","00","4","8","56031","56","031",8145,8033,112,56,56
"Sheridan County","Sheridan County, Wyoming","050","00","4","8","56033","56","033",23562,23215,347,225,122
"Sublette County","Sublette County, Wyoming","050","00","4","8","56035","56","035",4843,4796,47,27,20
"Sweetwater County","Sweetwater County, Wyoming","050","00","4","8","56037","56","037",38823,38120,703,466,237
"Teton County","Teton County, Wyoming","050","00","4","8","56039","56","039",11172,10997,175,81,94
"Uinta County","Uinta County, Wyoming","050","00","4","8","56041","56","041",18705,18413,292,59,233
"Washakie County","Washakie County, Wyoming","050","00","4","8","56043","56","043",8388,8269,119,95,24
"Weston County","Weston County, Wyoming","050","00","4","8","56045","56","045",6518,6490,28,19,9
