Geo_NAME,Geo_QName,Geo_AREALAND,Geo_AREAWATR,Geo_SUMLEV,Geo_GEOCOMP,Geo_REGION,Geo_DIVISION,Geo_FIPS,Geo_STATE,Geo_COUNTY,SE_T201_001,SE_T201_002,SE_T201_003,SE_T201_004,SE_T201_005
"Autauga County","Autauga County, Alabama","1543550050","21959029   ","050","00","3","6","01001","01","001",43671,43162,509,312,197
"Baldwin County","Baldwin County, Alabama","4134518782","1115203109 ","050","00","3","6","01003","01","003",140415,137458,2957,1143,1814
"Barbour County","Barbour County, Alabama","2291889572","50799584   ","050","00","3","6","01005","01","005",29038,28603,435,75,360
"Bibb County","Bibb County, Alabama","1613627425","8124469    ","050","00","3","6","01007","01","007",20826,20737,89,12,77
"Blount County","Blount County, Alabama","1672057889","12998871   ","050","00","3","6","01009","01","009",51024,49443,1581,277,1304
"Bullock County","Bullock County, Alabama","1618775183","2703063    ","050","00","3","6","01011","01","011",11714,11356,358,58,300
"Butler County","Butler County, Alabama","2012076972","2732130    ","050","00","3","6","01013","01","013",21399,21321,78,53,25
"Calhoun County","Calhoun County, Alabama","1575907564","9996496    ","050","00","3","6","01015","01","015",112249,110342,1907,946,961
"Chambers County","Chambers County, Alabama","1546657021","15382288   ","050","00","3","6","01017","01","017",36583,36289,294,63,231
"Cherokee County","Cherokee County, Alabama","1432576264","121290944  ","050","00","3","6","01019","01","019",23988,23729,259,91,168
"Chilton County","Chilton County, Alabama","1797396705","17552968   ","050","00","3","6","01021","01","021",39593,38846,747,229,518
"Choctaw County","Choctaw County, Alabama","2365990097","18999051   ","050","00","3","6","01023","01","023",15922,15834,88,28,60
"Clarke County","Clarke County, Alabama","3207377186","36596298   ","050","00","3","6","01025","01","025",27867,27718,149,96,53
"Clay County","Clay County, Alabama","1567134311","2403035    ","050","00","3","6","01027","01","027",14254,14127,127,70,57
"Cleburne County","Cleburne County, Alabama","1450940300","2089814    ","050","00","3","6","01029","01","029",14123,13990,133,52,81
"Coffee County","Coffee County, Alabama","1758576346","3854683    ","050","00","3","6","01031","01","031",43615,42457,1158,610,548
"Colbert County","Colbert County, Alabama","1539831753","75305160   ","050","00","3","6","01033","01","033",54984,54499,485,245,240
"Conecuh County","Conecuh County, Alabama","2203546316","4436364    ","050","00","3","6","01035","01","035",14089,14035,54,28,26
"Coosa County","Coosa County, Alabama","1689820597","36039382   ","050","00","3","6","01037","01","037",12202,12163,39,12,27
"Covington County","Covington County, Alabama","2677571159","26020615   ","050","00","3","6","01039","01","039",37631,37415,216,99,117
"Crenshaw County","Crenshaw County, Alabama","1578805448","3354388    ","050","00","3","6","01041","01","041",13665,13629,36,20,16
"Cullman County","Cullman County, Alabama","1912519740","42457211   ","050","00","3","6","01043","01","043",77483,76153,1330,325,1005
"Dale County","Dale County, Alabama","1453174505","4146470    ","050","00","3","6","01045","01","045",49129,47626,1503,721,782
"Dallas County","Dallas County, Alabama","2540033739","32793461   ","050","00","3","6","01047","01","047",46365,46043,322,138,184
"DeKalb County","DeKalb County, Alabama","2014784830","1908435    ","050","00","3","6","01049","01","049",64452,61804,2648,424,2224
"Elmore County","Elmore County, Alabama","1609044562","93127438   ","050","00","3","6","01051","01","051",65874,65161,713,374,339
"Escambia County","Escambia County, Alabama","2453710209","14424173   ","050","00","3","6","01053","01","053",38440,38206,234,85,149
"Etowah County","Etowah County, Alabama","1385183532","36080591   ","050","00","3","6","01055","01","055",103459,101772,1687,446,1241
"Fayette County","Fayette County, Alabama","1625632174","4354945    ","050","00","3","6","01057","01","057",18495,18368,127,14,113
"Franklin County","Franklin County, Alabama","1646312169","28139961   ","050","00","3","6","01059","01","059",31223,29489,1734,250,1484
"Geneva County","Geneva County, Alabama","1492559453","6793742    ","050","00","3","6","01061","01","061",25764,25567,197,115,82
"Greene County","Greene County, Alabama","1672782673","36438301   ","050","00","3","6","01063","01","063",9974,9907,67,39,28
"Hale County","Hale County, Alabama","1667267304","32984565   ","050","00","3","6","01065","01","065",17185,17132,53,46,7
"Henry County","Henry County, Alabama","1455045371","16913484   ","050","00","3","6","01067","01","067",16310,16126,184,64,120
"Houston County","Houston County, Alabama","1503124582","3351697    ","050","00","3","6","01069","01","069",88787,87369,1418,571,847
"Jackson County","Jackson County, Alabama","2793932065","124376317  ","050","00","3","6","01071","01","071",53926,53531,395,181,214
"Jefferson County","Jefferson County, Alabama","2881639146","28998564   ","050","00","3","6","01073","01","073",662047,646555,15492,4946,10546
"Lamar County","Lamar County, Alabama","1566546589","1600546    ","050","00","3","6","01075","01","075",15904,15776,128,22,106
"Lauderdale County","Lauderdale County, Alabama","1733895504","127745460  ","050","00","3","6","01077","01","077",87966,87077,889,356,533
"Lawrence County","Lawrence County, Alabama","1795852273","63932890   ","050","00","3","6","01079","01","079",34803,34627,176,66,110
"Lee County","Lee County, Alabama","1576552257","17723094   ","050","00","3","6","01081","01","081",115092,112003,3089,1063,2026
"Limestone County","Limestone County, Alabama","1471241120","101090592  ","050","00","3","6","01083","01","083",65676,64581,1095,368,727
"Lowndes County","Lowndes County, Alabama","1859446869","18376863   ","050","00","3","6","01085","01","085",13473,13437,36,16,20
"Macon County","Macon County, Alabama","1581247720","7042123    ","050","00","3","6","01087","01","087",24105,23755,350,103,247
"Madison County","Madison County, Alabama","2084739506","20532503   ","050","00","3","6","01089","01","089",276700,265724,10976,4820,6156
"Marengo County","Marengo County, Alabama","2530533970","15034262   ","050","00","3","6","01091","01","091",22539,22373,166,23,143
"Marion County","Marion County, Alabama","1920255331","5586055    ","050","00","3","6","01093","01","093",31214,31064,150,58,92
"Marshall County","Marshall County, Alabama","1468677998","145303458  ","050","00","3","6","01095","01","095",82231,78919,3312,692,2620
"Mobile County","Mobile County, Alabama","3193690623","1064308706 ","050","00","3","6","01097","01","097",399843,390710,9133,3792,5341
"Monroe County","Monroe County, Alabama","2656951618","22457590   ","050","00","3","6","01099","01","099",24324,24242,82,52,30
"Montgomery County","Montgomery County, Alabama","2045477293","25880189   ","050","00","3","6","01101","01","101",223510,219067,4443,2205,2238
"Morgan County","Morgan County, Alabama","1507925725","43627686   ","050","00","3","6","01103","01","103",111064,108057,3007,1156,1851
"Perry County","Perry County, Alabama","1863454321","11896118   ","050","00","3","6","01105","01","105",11861,11803,58,38,20
"Pickens County","Pickens County, Alabama","2282862165","22363229   ","050","00","3","6","01107","01","107",20949,20869,80,54,26
"Pike County","Pike County, Alabama","1737968630","2749829    ","050","00","3","6","01109","01","109",29605,29030,575,129,446
"Randolph County","Randolph County, Alabama","1504900000","7934149    ","050","00","3","6","01111","01","111",22380,22111,269,117,152
"Russell County","Russell County, Alabama","1661003813","15699413   ","050","00","3","6","01113","01","113",49756,48753,1003,481,522
"St. Clair County","St. Clair County, Alabama","1641410695","51432687   ","050","00","3","6","01115","01","115",64742,64329,413,204,209
"Shelby County","Shelby County, Alabama","2058248819","38413582   ","050","00","3","6","01117","01","117",143293,139904,3389,1300,2089
"Sumter County","Sumter County, Alabama","2343771409","21667529   ","050","00","3","6","01119","01","119",14798,14728,70,41,29
"Talladega County","Talladega County, Alabama","1915378668","53656638   ","050","00","3","6","01121","01","121",80321,79780,541,259,282
"Tallapoosa County","Tallapoosa County, Alabama","1859437932","125097133  ","050","00","3","6","01123","01","123",41475,41292,183,128,55
"Tuscaloosa County","Tuscaloosa County, Alabama","3430104517","69553838   ","050","00","3","6","01125","01","125",164875,161416,3459,1098,2361
"Walker County","Walker County, Alabama","2057463774","28245606   ","050","00","3","6","01127","01","127",70713,70200,513,147,366
"Washington County","Washington County, Alabama","2798888327","20423419   ","050","00","3","6","01129","01","129",18097,18011,86,78,8
"Wilcox County","Wilcox County, Alabama","2301677587","48643939   ","050","00","3","6","01131","01","131",13183,13142,41,18,23
"Winston County","Winston County, Alabama","1591383854","45113969   ","050","00","3","6","01133","01","133",24843,24586,257,58,199
"Aleutians East Borough","Aleutians East Borough, Alaska","18099208933","20780667723","050","00","4","9","02013","02","013",2697,2204,493,165,328
"Aleutians West Census Area","Aleutians West Census Area, Alaska","11387589341","25173999631","050","00","4","9","02016","02","016",5465,4291,1174,473,701
"Anchorage Municipality","Anchorage Municipality, Alaska","4395766279","683445939  ","050","00","4","9","02020","02","020",260283,239005,21278,11631,9647
"Bethel Census Area","Bethel Census Area, Alaska","105239784563","12626578961","050","00","4","9","02050","02","050",16006,15789,217,101,116
"Bristol Bay Borough","Bristol Bay Borough, Alaska","1307725488","991362678  ","050","00","4","9","02060","02","060",1258,1251,7,5,2
"Denali Borough","Denali Borough, Alaska","33021449878","64433414   ","050","00","4","9","02068","02","068",1893,1839,54,17,37
"Dillingham Census Area","Dillingham Census Area, Alaska","48367450285","5836871668 ","050","00","4","9","02070","02","070",4922,4873,49,19,30
"Fairbanks North Star Borough","Fairbanks North Star Borough, Alaska","19078483082","201438083  ","050","00","4","9","02090","02","090",82840,79487,3353,1735,1618
"Haines Borough","Haines Borough, Alaska","6070244109","989605130  ","050","00","4","9","02100","02","100",2392,2295,97,68,29
"Juneau City and Borough","Juneau City and Borough, Alaska","7036141369","1394301430 ","050","00","4","9","02110","02","110",30711,28951,1760,1042,718
"Kenai Peninsula Borough","Kenai Peninsula Borough, Alaska","41474147137","22639962070","050","00","4","9","02122","02","122",49691,48335,1356,872,484
"Ketchikan Gateway Borough","Ketchikan Gateway Borough, Alaska","3194034374","1348745006 ","050","00","4","9","02130","02","130",14070,13262,808,586,222
"Kodiak Island Borough","Kodiak Island Borough, Alaska","16989921131","14151251696","050","00","4","9","02150","02","150",13913,11591,2322,1152,1170
"Lake and Peninsula Borough","Lake and Peninsula Borough, Alaska","61594989981","18453667773","050","00","4","9","02164","02","164",1823,1811,12,6,6
"Matanuska-Susitna Borough","Matanuska-Susitna Borough, Alaska","63924889623","1497666767 ","050","00","4","9","02170","02","170",59322,57798,1524,813,711
"Nome Census Area","Nome Census Area, Alaska","59572081811","13681400029","050","00","4","9","02180","02","180",9196,9057,139,84,55
"North Slope Borough","North Slope Borough, Alaska","230035263166","15398849303","050","00","4","9","02185","02","185",7385,6955,430,273,157
"Northwest Arctic Borough","Northwest Arctic Borough, Alaska","92976270484","12596823585","050","00","4","9","02188","02","188",7208,7132,76,45,31
"Prince of Wales-Outer Ketchikan Census Area","Prince of Wales-Outer Ketchikan Census Area, Alaska","19193422932","13715730157","050","00","4","9","02201","02","201",6146,6038,108,69,39
"Sitka City and Borough","Sitka City and Borough, Alaska","7443577063","5018227281 ","050","00","4","9","02220","02","220",8835,8388,447,271,176
"Skagway-Hoonah-Angoon Census Area","Skagway-Hoonah-Angoon Census Area, Alaska","20451795008","9013806170 ","050","00","4","9","02232","02","232",3436,3368,68,39,29
"Southeast Fairbanks Census Area","Southeast Fairbanks Census Area, Alaska","64270183513","637996435  ","050","00","4","9","02240","02","240",6174,5564,610,124,486
"Valdez-Cordova Census Area","Valdez-Cordova Census Area, Alaska","88886050122","15229266352","050","00","4","9","02261","02","261",10195,9677,518,259,259
"Wade Hampton Census Area","Wade Hampton Census Area, Alaska","44530953609","6412136001 ","050","00","4","9","02270","02","270",7028,7010,18,9,9
"Wrangell-Petersburg Census Area","Wrangell-Petersburg Census Area, Alaska","15112433221","8252397782 ","050","00","4","9","02280","02","280",6684,6500,184,100,84
"Yakutat City and Borough","Yakutat City and Borough, Alaska","19814593290","4684825424 ","050","00","4","9","02282","02","282",808,803,5,2,3
"Yukon-Koyukuk Census Area","Yukon-Koyukuk Census Area, Alaska","377878437401","5031897827 ","050","00","4","9","02290","02","290",6551,6488,63,51,12
"Apache County","Apache County, Arizona","29020502286","35069942   ","050","00","4","8","04001","04","001",69423,68820,603,221,382
"Cochise County","Cochise County, Arizona","15978796535","127742070  ","050","00","4","8","04003","04","003",117755,103317,14438,7083,7355
"Coconino County","Coconino County, Arizona","48218904679","113408657  ","050","00","4","8","04005","04","005",116320,111269,5051,1609,3442
"Gila County","Gila County, Arizona","12348294231","72606847   ","050","00","4","8","04007","04","007",51335,49512,1823,847,976
"Graham County","Graham County, Arizona","11989870698","30635420   ","050","00","4","8","04009","04","009",33489,32607,882,438,444
"Greenlee County","Greenlee County, Arizona","4783710414","3665171    ","050","00","4","8","04011","04","011",8547,8260,287,140,147
"La Paz County","La Paz County, Arizona","11654826790","34717106   ","050","00","4","8","04012","04","012",19715,17798,1917,487,1430
"Maricopa County","Maricopa County, Arizona","23836016480","54722478   ","050","00","4","8","04013","04","013",3072149,2630909,441240,114048,327192
"Mohave County","Mohave County, Arizona","34476991534","409405407  ","050","00","4","8","04015","04","015",155032,145918,9114,3666,5448
"Navajo County","Navajo County, Arizona","25778620688","16344185   ","050","00","4","8","04017","04","017",97470,95816,1654,633,1021
"Pima County","Pima County, Arizona","23792316898","6644112    ","050","00","4","8","04019","04","019",843746,743696,100050,39665,60385
"Pinal County","Pinal County, Arizona","13907185407","11653422   ","050","00","4","8","04021","04","021",179727,163484,16243,4326,11917
"Santa Cruz County","Santa Cruz County, Arizona","3205457073","1227457    ","050","00","4","8","04023","04","023",38381,23924,14457,6688,7769
"Yavapai County","Yavapai County, Arizona","21039252624","11603654   ","050","00","4","8","04025","04","025",167517,157572,9945,3868,6077
"Yuma County","Yuma County, Arizona","14281424443","12613327   ","050","00","4","8","04027","04","027",160026,121547,38479,10225,28254
"Arkansas County","Arkansas County, Arkansas","2560177487","117328433  ","050","00","3","7","05001","05","001",20749,20666,83,37,46
"Ashley County","Ashley County, Arkansas","2385761562","46447703   ","050","00","3","7","05003","05","003",24209,23681,528,211,317
"Baxter County","Baxter County, Arkansas","1435789253","83859190   ","050","00","3","7","05005","05","005",38386,37765,621,493,128
"Benton County","Benton County, Arkansas","2191114121","88700645   ","050","00","3","7","05007","05","007",153406,143550,9856,2393,7463
"Boone County","Boone County, Arkansas","1531141397","27563192   ","050","00","3","7","05009","05","009",33948,33621,327,173,154
"Bradley County","Bradley County, Arkansas","1685119713","9715126    ","050","00","3","7","05011","05","011",12600,12056,544,141,403
"Calhoun County","Calhoun County, Arkansas","1627223264","11050088   ","050","00","3","7","05013","05","013",5744,5691,53,8,45
"Carroll County","Carroll County, Arkansas","1632402948","22109108   ","050","00","3","7","05015","05","015",25357,23455,1902,364,1538
"Chicot County","Chicot County, Arkansas","1668022627","121360211  ","050","00","3","7","05017","05","017",14117,13786,331,110,221
"Clark County","Clark County, Arkansas","2241461032","44470582   ","050","00","3","7","05019","05","019",23546,23064,482,83,399
"Clay County","Clay County, Arkansas","1655774222","5484984    ","050","00","3","7","05021","05","021",17609,17553,56,35,21
"Cleburne County","Cleburne County, Arkansas","1432389875","100649118  ","050","00","3","7","05023","05","023",24046,23787,259,111,148
"Cleveland County","Cleveland County, Arkansas","1548136778","2753551    ","050","00","3","7","05025","05","025",8571,8448,123,30,93
"Columbia County","Columbia County, Arkansas","1984225864","1935498    ","050","00","3","7","05027","05","027",25603,25382,221,68,153
"Conway County","Conway County, Arkansas","1440420568","27231140   ","050","00","3","7","05029","05","029",20336,20082,254,69,185
"Craighead County","Craighead County, Arkansas","1841065959","5533069    ","050","00","3","7","05031","05","031",82148,80531,1617,316,1301
"Crawford County","Crawford County, Arkansas","1542060108","22805968   ","050","00","3","7","05033","05","033",53247,51983,1264,506,758
"Crittenden County","Crittenden County, Arkansas","1580323104","68687085   ","050","00","3","7","05035","05","035",50866,50257,609,254,355
"Cross County","Cross County, Arkansas","1595034998","16800413   ","050","00","3","7","05037","05","037",19526,19329,197,77,120
"Dallas County","Dallas County, Arkansas","1728609957","1919275    ","050","00","3","7","05039","05","039",9210,9129,81,14,67
"Desha County","Desha County, Arkansas","1981313426","141231808  ","050","00","3","7","05041","05","041",15341,15023,318,93,225
"Drew County","Drew County, Arkansas","2144980532","19353359   ","050","00","3","7","05043","05","043",18723,18445,278,59,219
"Faulkner County","Faulkner County, Arkansas","1676702498","43078811   ","050","00","3","7","05045","05","045",86014,84586,1428,523,905
"Franklin County","Franklin County, Arkansas","1578738873","26238447   ","050","00","3","7","05047","05","047",17771,17539,232,79,153
"Fulton County","Fulton County, Arkansas","1601015098","5593232    ","050","00","3","7","05049","05","049",11642,11596,46,22,24
"Garland County","Garland County, Arkansas","1753998615","148540166  ","050","00","3","7","05051","05","051",88068,85754,2314,1185,1129
"Grant County","Grant County, Arkansas","1636294639","3194372    ","050","00","3","7","05053","05","053",16464,16364,100,32,68
"Greene County","Greene County, Arkansas","1495741684","5535135    ","050","00","3","7","05055","05","055",37331,37128,203,98,105
"Hempstead County","Hempstead County, Arkansas","1887515647","32604215   ","050","00","3","7","05057","05","057",23587,22068,1519,324,1195
"Hot Spring County","Hot Spring County, Arkansas","1592668724","18708143   ","050","00","3","7","05059","05","059",30353,29974,379,130,249
"Howard County","Howard County, Arkansas","1521413675","20153742   ","050","00","3","7","05061","05","061",14300,13793,507,63,444
"Independence County","Independence County, Arkansas","1978183758","20183074   ","050","00","3","7","05063","05","063",34233,33813,420,100,320
"Izard County","Izard County, Arkansas","1503963686","8640533    ","050","00","3","7","05065","05","065",13249,13145,104,79,25
"Jackson County","Jackson County, Arkansas","1640818713","20519620   ","050","00","3","7","05067","05","067",18418,18331,87,18,69
"Jefferson County","Jefferson County, Arkansas","2291661025","74801688   ","050","00","3","7","05069","05","069",84278,83328,950,299,651
"Johnson County","Johnson County, Arkansas","1715007779","53288421   ","050","00","3","7","05071","05","071",22781,21761,1020,125,895
"Lafayette County","Lafayette County, Arkansas","1363620948","48091961   ","050","00","3","7","05073","05","073",8559,8477,82,32,50
"Lawrence County","Lawrence County, Arkansas","1519202550","14957296   ","050","00","3","7","05075","05","075",17774,17663,111,40,71
"Lee County","Lee County, Arkansas","1558301195","46109827   ","050","00","3","7","05077","05","077",12580,12536,44,12,32
"Lincoln County","Lincoln County, Arkansas","1453505517","28401658   ","050","00","3","7","05079","05","079",14492,14387,105,24,81
"Little River County","Little River County, Arkansas","1377184049","85823803   ","050","00","3","7","05081","05","081",13628,13394,234,125,109
"Logan County","Logan County, Arkansas","1838562451","56023081   ","050","00","3","7","05083","05","083",22486,22285,201,102,99
"Lonoke County","Lonoke County, Arkansas","1983828425","94450249   ","050","00","3","7","05085","05","085",52828,52106,722,324,398
"Madison County","Madison County, Arkansas","2167336831","648241     ","050","00","3","7","05087","05","087",14243,13992,251,46,205
"Marion County","Marion County, Arkansas","1548040144","110451459  ","050","00","3","7","05089","05","089",16140,15962,178,114,64
"Miller County","Miller County, Arkansas","1616097588","34967325   ","050","00","3","7","05091","05","091",40443,39987,456,118,338
"Mississippi County","Mississippi County, Arkansas","2326453080","55635025   ","050","00","3","7","05093","05","093",51979,51362,617,200,417
"Monroe County","Monroe County, Arkansas","1571207189","38240567   ","050","00","3","7","05095","05","095",10254,10198,56,10,46
"Montgomery County","Montgomery County, Arkansas","2022591566","50139601   ","050","00","3","7","05097","05","097",9245,9060,185,15,170
"Nevada County","Nevada County, Arkansas","1605671916","2138354    ","050","00","3","7","05099","05","099",9955,9845,110,29,81
"Newton County","Newton County, Arkansas","2131479507","550305     ","050","00","3","7","05101","05","101",8608,8563,45,21,24
"Ouachita County","Ouachita County, Arkansas","1897037646","18601184   ","050","00","3","7","05103","05","103",28790,28596,194,76,118
"Perry County","Perry County, Arkansas","1426937645","24678846   ","050","00","3","7","05105","05","105",10209,10129,80,67,13
"Phillips County","Phillips County, Arkansas","1794011405","89657658   ","050","00","3","7","05107","05","107",26445,26156,289,165,124
"Pike County","Pike County, Arkansas","1561784452","28160233   ","050","00","3","7","05109","05","109",11303,11056,247,25,222
"Poinsett County","Poinsett County, Arkansas","1962534369","14627018   ","050","00","3","7","05111","05","111",25614,25393,221,37,184
"Polk County","Polk County, Arkansas","2225780691","7876636    ","050","00","3","7","05113","05","113",20229,19691,538,227,311
"Pope County","Pope County, Arkansas","2102811754","48921339   ","050","00","3","7","05115","05","115",54469,53522,947,273,674
"Prairie County","Prairie County, Arkansas","1672962375","77251283   ","050","00","3","7","05117","05","117",9539,9500,39,19,20
"Pulaski County","Pulaski County, Arkansas","1996416793","95884135   ","050","00","3","7","05119","05","119",361474,350638,10836,4457,6379
"Randolph County","Randolph County, Arkansas","1688216567","10911454   ","050","00","3","7","05121","05","121",18195,18034,161,56,105
"St. Francis County","St. Francis County, Arkansas","1641628992","22169936   ","050","00","3","7","05123","05","123",29329,29250,79,36,43
"Saline County","Saline County, Arkansas","1873756910","18137769   ","050","00","3","7","05125","05","125",83529,82410,1119,475,644
"Scott County","Scott County, Arkansas","2315138467","10909264   ","050","00","3","7","05127","05","127",10996,10612,384,72,312
"Searcy County","Searcy County, Arkansas","1727908178","3519587    ","050","00","3","7","05129","05","129",8261,8213,48,24,24
"Sebastian County","Sebastian County, Arkansas","1388864138","25366668   ","050","00","3","7","05131","05","131",115071,107149,7922,2208,5714
"Sevier County","Sevier County, Arkansas","1460600945","45080895   ","050","00","3","7","05133","05","133",15757,13755,2002,471,1531
"Sharp County","Sharp County, Arkansas","1565267826","5158769    ","050","00","3","7","05135","05","135",17119,16986,133,88,45
"Stone County","Stone County, Arkansas","1571066263","7344646    ","050","00","3","7","05137","05","137",11499,11403,96,73,23
"Union County","Union County, Arkansas","2690745020","42392663   ","050","00","3","7","05139","05","139",45629,45094,535,161,374
"Van Buren County","Van Buren County, Arkansas","1842811977","33166480   ","050","00","3","7","05141","05","141",16192,15968,224,151,73
"Washington County","Washington County, Arkansas","2459756258","16296853   ","050","00","3","7","05143","05","143",157715,146009,11706,2305,9401
"White County","White County, Arkansas","2678123867","21572200   ","050","00","3","7","05145","05","145",67165,66182,983,307,676
"Woodruff County","Woodruff County, Arkansas","1519193180","19400728   ","050","00","3","7","05147","05","147",8741,8691,50,16,34
"Yell County","Yell County, Arkansas","2403227487","54263565   ","050","00","3","7","05149","05","149",21139,18992,2147,332,1815
"Alameda County","Alameda County, California","1910302974","216454242  ","050","00","4","9","06001","06","001",1443741,1051085,392656,169708,222948
"Alpine County","Alpine County, California","1913008753","11842922   ","050","00","4","9","06003","06","003",1208,1169,39,18,21
"Amador County","Amador County, California","1535775543","30367858   ","050","00","4","9","06005","06","005",35100,33920,1180,736,444
"Butte County","Butte County, California","4246255361","97428420   ","050","00","4","9","06007","06","007",203171,187503,15668,5920,9748
"Calaveras County","Calaveras County, California","2641887224","43527582   ","050","00","4","9","06009","06","009",40554,39335,1219,730,489
"Colusa County","Colusa County, California","2980234877","14359155   ","050","00","4","9","06011","06","011",18804,13623,5181,1226,3955
"Contra Costa County","Contra Costa County, California","1864651611","212906588  ","050","00","4","9","06013","06","013",948816,768328,180488,82317,98171
"Del Norte County","Del Norte County, California","2610221532","574823230  ","050","00","4","9","06015","06","015",27507,25928,1579,460,1119
"El Dorado County","El Dorado County, California","4431073269","200075503  ","050","00","4","9","06017","06","017",156299,145116,11183,4548,6635
"Fresno County","Fresno County, California","15443387242","141660122  ","050","00","4","9","06019","06","019",799407,630690,168717,49397,119320
"Glenn County","Glenn County, California","3405298392","32019600   ","050","00","4","9","06021","06","021",26453,21734,4719,1174,3545
"Humboldt County","Humboldt County, California","9252700018","1242513384 ","050","00","4","9","06023","06","023",126518,120769,5749,2739,3010
"Imperial County","Imperial County, California","10812506906","795121274  ","050","00","4","9","06025","06","025",142361,96578,45783,17942,27841
"Inyo County","Inyo County, California","26425906085","61843146   ","050","00","4","9","06027","06","027",17945,16578,1367,530,837
"Kern County","Kern County, California","21085000353","52980904   ","050","00","4","9","06029","06","029",661645,549701,111944,33590,78354
"Kings County","Kings County, California","3602654510","1291278    ","050","00","4","9","06031","06","031",129461,108704,20757,6206,14551
"Lake County","Lake County, California","3258098255","185236984  ","050","00","4","9","06033","06","033",58309,54487,3822,1706,2116
"Lassen County","Lassen County, California","11803267612","422439110  ","050","00","4","9","06035","06","035",33828,33039,789,438,351
"Los Angeles County","Los Angeles County, California","10517607254","1790852700 ","050","00","4","9","06037","06","037",9519338,6069894,3449444,1311755,2137689
"Madera County","Madera County, California","5531855540","45223370   ","050","00","4","9","06039","06","039",123109,98356,24753,6089,18664
"Marin County","Marin County, California","1346283474","798731740  ","050","00","4","9","06041","06","041",247289,206129,41160,17086,24074
"Mariposa County","Mariposa County, California","3758384025","30217838   ","050","00","4","9","06043","06","043",17130,16655,475,329,146
"Mendocino County","Mendocino County, California","9088191116","956135793  ","050","00","4","9","06045","06","045",86265,77432,8833,2485,6348
"Merced County","Merced County, California","4995295707","111833232  ","050","00","4","9","06047","06","047",210554,158370,52184,16809,35375
"Modoc County","Modoc County, California","10215163611","671524702  ","050","00","4","9","06049","06","049",9449,8893,556,169,387
"Mono County","Mono County, California","7884956227","226369633  ","050","00","4","9","06051","06","051",12853,11255,1598,388,1210
"Monterey County","Monterey County, California","8603818751","1163213553 ","050","00","4","9","06053","06","053",401762,285203,116559,33530,83029
"Napa County","Napa County, California","1952160868","89443626   ","050","00","4","9","06055","06","055",124279,101792,22487,7241,15246
"Nevada County","Nevada County, California","2480205755","43715169   ","050","00","4","9","06057","06","057",92033,87968,4065,2061,2004
"Orange County","Orange County, California","2044547652","410699725  ","050","00","4","9","06059","06","059",2846289,1996390,849899,322592,527307
"Placer County","Placer County, California","3637294463","254882245  ","050","00","4","9","06061","06","061",248399,230837,17562,8402,9160
"Plumas County","Plumas County, California","6614039250","154838986  ","050","00","4","9","06063","06","063",20824,20298,526,271,255
"Riverside County","Riverside County, California","18666999221","248019369  ","050","00","4","9","06065","06","065",1545387,1251675,293712,106834,186878
"Sacramento County","Sacramento County, California","2501026086","77260881   ","050","00","4","9","06067","06","067",1223499,1026304,197195,83982,113213
"San Benito County","San Benito County, California","3597644798","4341176    ","050","00","4","9","06069","06","069",53234,43208,10026,3282,6744
"San Bernardino County","San Bernardino County, California","51935723751","136803389  ","050","00","4","9","06071","06","071",1709434,1390787,318647,120983,197664
"San Diego County","San Diego County, California","10877666909","843363020  ","050","00","4","9","06073","06","073",2813833,2207579,606254,250125,356129
"San Francisco County","San Francisco County, California","120938107","479723545  ","050","00","4","9","06075","06","075",776733,491192,285541,163426,122115
"San Joaquin County","San Joaquin County, California","3624124428","69844755   ","050","00","4","9","06077","06","077",563598,453786,109812,39437,70375
"San Luis Obispo County","San Luis Obispo County, California","8558152840","806063654  ","050","00","4","9","06079","06","079",246681,224665,22016,8924,13092
"San Mateo County","San Mateo County, California","1163077263","756138288  ","050","00","4","9","06081","06","081",707161,479043,228118,111735,116383
"Santa Barbara County","Santa Barbara County, California","7088826764","2724845772 ","050","00","4","9","06083","06","083",399347,314521,84826,27490,57336
"Santa Clara County","Santa Clara County, California","3342865290","34494463   ","050","00","4","9","06085","06","085",1682585,1109455,573130,235952,337178
"Santa Cruz County","Santa Cruz County, California","1153169845","419361484  ","050","00","4","9","06087","06","087",255602,209100,46502,14643,31859
"Shasta County","Shasta County, California","9803608907","161203391  ","050","00","4","9","06089","06","089",163256,156768,6488,3012,3476
"Sierra County","Sierra County, California","2469247836","22253781   ","050","00","4","9","06091","06","091",3555,3448,107,55,52
"Siskiyou County","Siskiyou County, California","16282696756","157153505  ","050","00","4","9","06093","06","093",44301,41919,2382,1052,1330
"Solano County","Solano County, California","2147592310","200674674  ","050","00","4","9","06095","06","095",394542,328046,66496,35301,31195
"Sonoma County","Sonoma County, California","4081505939","498177886  ","050","00","4","9","06097","06","097",458614,392888,65726,22335,43391
"Stanislaus County","Stanislaus County, California","3868899889","54072211   ","050","00","4","9","06099","06","099",446997,365382,81615,30603,51012
"Sutter County","Sutter County, California","1560579911","15642554   ","050","00","4","9","06101","06","101",78930,63702,15228,5333,9895
"Tehama County","Tehama County, California","7643021084","29224867   ","050","00","4","9","06103","06","103",56039,51615,4424,1378,3046
"Trinity County","Trinity County, California","8232554997","74937644   ","050","00","4","9","06105","06","105",13022,12816,206,104,102
"Tulare County","Tulare County, California","12494018673","39164606   ","050","00","4","9","06107","06","107",368021,284897,83124,21567,61557
"Tuolumne County","Tuolumne County, California","5789697024","100823961  ","050","00","4","9","06109","06","109",54501,52777,1724,1075,649
"Ventura County","Ventura County, California","4779302398","939900119  ","050","00","4","9","06111","06","111",753197,597284,155913,61540,94373
"Yolo County","Yolo County, California","2624350750","24920133   ","050","00","4","9","06113","06","113",168660,134489,34171,11911,22260
"Yuba County","Yuba County, California","1633489210","33768609   ","050","00","4","9","06115","06","115",60219,52288,7931,2595,5336
"Adams County","Adams County, Colorado","3087083897","14964913   ","050","00","4","8","08001","08","001",363857,318269,45588,12266,33322
"Alamosa County","Alamosa County, Colorado","1871896200","2030248    ","050","00","4","8","08003","08","003",14966,14263,703,218,485
"Arapahoe County","Arapahoe County, Colorado","2080134653","5929612    ","050","00","4","8","08005","08","005",487967,434525,53442,19668,33774
"Archuleta County","Archuleta County, Colorado","3497066239","13612883   ","050","00","4","8","08007","08","007",9898,9608,290,158,132
"Baca County","Baca County, Colorado","6619277678","3542887    ","050","00","4","8","08009","08","009",4517,4405,112,49,63
"Bent County","Bent County, Colorado","3920990264","70493645   ","050","00","4","8","08011","08","011",5998,5732,266,85,181
"Boulder County","Boulder County, Colorado","1922962810","23080988   ","050","00","4","8","08013","08","013",291288,264009,27279,7923,19356
"Chaffee County","Chaffee County, Colorado","2624826821","4025351    ","050","00","4","8","08015","08","015",16242,15919,323,180,143
"Cheyenne County","Cheyenne County, Colorado","4613673090","60028      ","050","00","4","8","08017","08","017",2231,2140,91,15,76
"Clear Creek County","Clear Creek County, Colorado","1024206164","2609887    ","050","00","4","8","08019","08","019",9322,9149,173,103,70
"Conejos County","Conejos County, Colorado","3333873637","9461565    ","050","00","4","8","08021","08","021",8400,8152,248,59,189
"Costilla County","Costilla County, Colorado","3178185817","8649231    ","050","00","4","8","08023","08","023",3663,3411,252,84,168
"Crowley County","Crowley County, Colorado","2043487287","29361121   ","050","00","4","8","08025","08","025",5518,5460,58,36,22
"Custer County","Custer County, Colorado","1913708938","2631222    ","050","00","4","8","08027","08","027",3503,3445,58,38,20
"Delta County","Delta County, Colorado","2958041854","16618868   ","050","00","4","8","08029","08","029",27834,26669,1165,290,875
"Denver County","Denver County, Colorado","397176192","4109354    ","050","00","4","8","08031","08","031",554636,458035,96601,22144,74457
"Dolores County","Dolores County, Colorado","2763428837","2921716    ","050","00","4","8","08033","08","033",1844,1827,17,5,12
"Douglas County","Douglas County, Colorado","2175880002","6828752    ","050","00","4","8","08035","08","035",175766,166701,9065,4244,4821
"Eagle County","Eagle County, Colorado","4371576296","10168506   ","050","00","4","8","08037","08","037",41659,34085,7574,1234,6340
"Elbert County","Elbert County, Colorado","4793500494","289484     ","050","00","4","8","08039","08","039",19872,19498,374,147,227
"El Paso County","El Paso County, Colorado","5507477052","8058755    ","050","00","4","8","08041","08","041",516929,483621,33308,16122,17186
"Fremont County","Fremont County, Colorado","3970269235","2652570    ","050","00","4","8","08043","08","043",46145,45458,687,309,378
"Garfield County","Garfield County, Colorado","7632842385","22544035   ","050","00","4","8","08045","08","045",43791,39228,4563,936,3627
"Gilpin County","Gilpin County, Colorado","388157523","1001047    ","050","00","4","8","08047","08","047",4757,4596,161,108,53
"Grand County","Grand County, Colorado","4782865409","59388993   ","050","00","4","8","08049","08","049",12442,12017,425,198,227
"Gunnison County","Gunnison County, Colorado","8388489064","54212844   ","050","00","4","8","08051","08","051",13956,13546,410,147,263
"Hinsdale County","Hinsdale County, Colorado","2894789684","14133153   ","050","00","4","8","08053","08","053",790,774,16,9,7
"Huerfano County","Huerfano County, Colorado","4120325675","6152131    ","050","00","4","8","08055","08","055",7862,7734,128,57,71
"Jackson County","Jackson County, Colorado","4178201772","20046468   ","050","00","4","8","08057","08","057",1577,1547,30,15,15
"Jefferson County","Jefferson County, Colorado","1999714135","15454869   ","050","00","4","8","08059","08","059",527056,498656,28400,12367,16033
"Kiowa County","Kiowa County, Colorado","4586848616","38236130   ","050","00","4","8","08061","08","061",1622,1599,23,8,15
"Kit Carson County","Kit Carson County, Colorado","5596629738","1787498    ","050","00","4","8","08063","08","063",8011,7547,464,107,357
"Lake County","Lake County, Colorado","976148215","18147119   ","050","00","4","8","08065","08","065",7812,6595,1217,235,982
"La Plata County","La Plata County, Colorado","4382649384","20145559   ","050","00","4","8","08067","08","067",43941,42770,1171,546,625
"Larimer County","Larimer County, Colorado","6737337334","84321662   ","050","00","4","8","08069","08","069",251494,240785,10709,4229,6480
"Las Animas County","Las Animas County, Colorado","12361063595","7217966    ","050","00","4","8","08071","08","071",15207,14850,357,112,245
"Lincoln County","Lincoln County, Colorado","6697949259","778973     ","050","00","4","8","08073","08","073",6087,5980,107,23,84
"Logan County","Logan County, Colorado","4761754388","16403444   ","050","00","4","8","08075","08","075",20504,19871,633,137,496
"Mesa County","Mesa County, Colorado","8618821990","34604691   ","050","00","4","8","08077","08","077",116255,112812,3443,1360,2083
"Mineral County","Mineral County, Colorado","2268101177","5143847    ","050","00","4","8","08079","08","079",831,825,6,4,2
"Moffat County","Moffat County, Colorado","12282380220","22502942   ","050","00","4","8","08081","08","081",13184,12638,546,115,431
"Montezuma County","Montezuma County, Colorado","5274855819","8641036    ","050","00","4","8","08083","08","083",23830,23313,517,237,280
"Montrose County","Montrose County, Colorado","5803157628","5080730    ","050","00","4","8","08085","08","085",33432,31569,1863,464,1399
"Morgan County","Morgan County, Colorado","3329068550","22029704   ","050","00","4","8","08087","08","087",27171,23195,3976,643,3333
"Otero County","Otero County, Colorado","3270782045","17839977   ","050","00","4","8","08089","08","089",20311,19321,990,193,797
"Ouray County","Ouray County, Colorado","1399806609","4506407    ","050","00","4","8","08091","08","091",3742,3622,120,66,54
"Park County","Park County, Colorado","5699763631","25897633   ","050","00","4","8","08093","08","093",14523,14206,317,208,109
"Phillips County","Phillips County, Colorado","1780932211","301806     ","050","00","4","8","08095","08","095",4480,4117,363,65,298
"Pitkin County","Pitkin County, Colorado","2513379920","7273435    ","050","00","4","8","08097","08","097",14872,13255,1617,588,1029
"Prowers County","Prowers County, Colorado","4248570375","10280082   ","050","00","4","8","08099","08","099",14483,12947,1536,285,1251
"Pueblo County","Pueblo County, Colorado","6186671073","23414372   ","050","00","4","8","08101","08","101",141472,137278,4194,1803,2391
"Rio Blanco County","Rio Blanco County, Colorado","8342274100","5025582    ","050","00","4","8","08103","08","103",5986,5797,189,66,123
"Rio Grande County","Rio Grande County, Colorado","2361045181","1384108    ","050","00","4","8","08105","08","105",12413,11668,745,338,407
"Routt County","Routt County, Colorado","6116485842","16647968   ","050","00","4","8","08107","08","107",19690,18886,804,175,629
"Saguache County","Saguache County, Colorado","8206210445","4701404    ","050","00","4","8","08109","08","109",5917,5060,857,191,666
"San Juan County","San Juan County, Colorado","1003420663","2232833    ","050","00","4","8","08111","08","111",558,544,14,9,5
"San Miguel County","San Miguel County, Colorado","3332026214","5139921    ","050","00","4","8","08113","08","113",6594,6114,480,84,396
"Sedgwick County","Sedgwick County, Colorado","1419924040","3530215    ","050","00","4","8","08115","08","115",2747,2672,75,16,59
"Summit County","Summit County, Colorado","1575131920","28720803   ","050","00","4","8","08117","08","117",23548,20810,2738,529,2209
"Teller County","Teller County, Colorado","1442785299","4902515    ","050","00","4","8","08119","08","119",20555,20184,371,249,122
"Washington County","Washington County, Colorado","6529308773","8118861    ","050","00","4","8","08121","08","121",4926,4802,124,32,92
"Weld County","Weld County, Colorado","10340389679","75395072   ","050","00","4","8","08123","08","123",180936,164184,16752,4411,12341
"Yuma County","Yuma County, Colorado","6127373276","8557668    ","050","00","4","8","08125","08","125",9841,9063,778,133,645
"Fairfield County","Fairfield County, Connecticut","1620819817","546885879  ","050","00","1","1","09001","09","001",882567,733529,149038,62953,86085
"Hartford County","Hartford County, Connecticut","1904779991","39192842   ","050","00","1","1","09003","09","003",857183,756490,100693,54803,45890
"Litchfield County","Litchfield County, Connecticut","2382586770","63848857   ","050","00","1","1","09005","09","005",182193,172295,9898,5928,3970
"Middlesex County","Middlesex County, Connecticut","956385973","180796624  ","050","00","1","1","09007","09","007",155071,145841,9230,5208,4022
"New Haven County","New Haven County, Connecticut","1568595966","664018638  ","050","00","1","1","09009","09","009",824008,749581,74427,36699,37728
"New London County","New London County, Connecticut","1724711552","273885845  ","050","00","1","1","09011","09","011",259088,245086,14002,7955,6047
"Tolland County","Tolland County, Connecticut","1062078671","17979036   ","050","00","1","1","09013","09","013",136364,128353,8011,4203,3808
"Windham County","Windham County, Connecticut","1328024634","22567134   ","050","00","1","1","09015","09","015",109091,104423,4668,2518,2150
"Kent County","Kent County, Delaware","1527371028","544921325  ","050","00","3","5","10001","10","001",126697,121647,5050,2605,2445
"New Castle County","New Castle County, Delaware","1104023324","174154862  ","050","00","3","5","10003","10","003",500265,467424,32841,14272,18569
"Sussex County","Sussex County, Delaware","2428312916","668395608  ","050","00","3","5","10005","10","005",156638,149631,7007,2175,4832
"District of Columbia","District of Columbia, District of Columbia","159033692","17968995   ","050","00","3","5","11001","11","001",572059,498498,73561,22050,51511
"Alachua County","Alachua County, Florida","2264284694","245733880  ","050","00","3","5","12001","12","001",217955,202060,15895,5956,9939
"Baker County","Baker County, Florida","1515692328","9513894    ","050","00","3","5","12003","12","003",22259,22009,250,104,146
"Bay County","Bay County, Florida","1977917239","698252537  ","050","00","3","5","12005","12","005",148217,142835,5382,2885,2497
"Bradford County","Bradford County, Florida","759210943","17892448   ","050","00","3","5","12007","12","007",26088,25629,459,306,153
"Brevard County","Brevard County, Florida","2637097850","1395383121 ","050","00","3","5","12009","12","009",476230,445229,31001,18374,12627
"Broward County","Broward County, Florida","3121961057","295873464  ","050","00","3","5","12011","12","011",1623018,1212631,410387,183641,226746
"Calhoun County","Calhoun County, Florida","1469328284","18195242   ","050","00","3","5","12013","12","013",13017,12731,286,162,124
"Charlotte County","Charlotte County, Florida","1796425560","428681612  ","050","00","3","5","12015","12","015",141627,130335,11292,6815,4477
"Citrus County","Citrus County, Florida","1512062538","490382908  ","050","00","3","5","12017","12","017",118085,112343,5742,3861,1881
"Clay County","Clay County, Florida","1556861192","110298278  ","050","00","3","5","12019","12","019",140814,134458,6356,3472,2884
"Collier County","Collier County, Florida","5245610020","724123671  ","050","00","3","5","12021","12","021",251377,205306,46071,14194,31877
"Columbia County","Columbia County, Florida","2064343146","10346659   ","050","00","3","5","12023","12","023",56513,55197,1316,779,537
"DeSoto County","DeSoto County, Florida","1650512416","5772119    ","050","00","3","5","12027","12","027",32209,26172,6037,761,5276
"Dixie County","Dixie County, Florida","1823390223","413482127  ","050","00","3","5","12029","12","029",13827,13545,282,153,129
"Duval County","Duval County, Florida","2003789932","374434073  ","050","00","3","5","12031","12","031",778879,733228,45651,21813,23838
"Escambia County","Escambia County, Florida","1715486995","552217280  ","050","00","3","5","12033","12","033",294410,283589,10821,6088,4733
"Flagler County","Flagler County, Florida","1256133782","222134845  ","050","00","3","5","12035","12","035",49832,44875,4957,3354,1603
"Franklin County","Franklin County, Florida","1409833626","1277222402 ","050","00","3","5","12037","12","037",11057,10847,210,105,105
"Gadsden County","Gadsden County, Florida","1336776162","31996266   ","050","00","3","5","12039","12","039",45087,43239,1848,481,1367
"Gilchrist County","Gilchrist County, Florida","903626096","17043801   ","050","00","3","5","12041","12","041",14437,14186,251,83,168
"Glades County","Glades County, Florida","2003731216","551116416  ","050","00","3","5","12043","12","043",10576,9737,839,367,472
"Gulf County","Gulf County, Florida","1436400451","492089137  ","050","00","3","5","12045","12","045",13332,13057,275,150,125
"Hamilton County","Hamilton County, Florida","1333486443","11520856   ","050","00","3","5","12047","12","047",13327,13027,300,78,222
"Hardee County","Hardee County, Florida","1650602844","2658258    ","050","00","3","5","12049","12","049",26938,22236,4702,794,3908
"Hendry County","Hendry County, Florida","2985049625","96495484   ","050","00","3","5","12051","12","051",36210,27510,8700,1916,6784
"Hernando County","Hernando County, Florida","1238813491","286903131  ","050","00","3","5","12053","12","053",130802,123860,6942,4701,2241
"Highlands County","Highlands County, Florida","2663204750","202045430  ","050","00","3","5","12055","12","055",87366,79454,7912,2795,5117
"Hillsborough County","Hillsborough County, Florida","2721840817","557661120  ","050","00","3","5","12057","12","057",998948,883797,115151,47127,68024
"Holmes County","Holmes County, Florida","1249536744","16209761   ","050","00","3","5","12059","12","059",18564,18244,320,162,158
"Indian River County","Indian River County, Florida","1303362423","294451401  ","050","00","3","5","12061","12","061",112947,103796,9151,4120,5031
"Jackson County","Jackson County, Florida","2371508002","100851072  ","050","00","3","5","12063","12","063",46755,46049,706,419,287
"Jefferson County","Jefferson County, Florida","1548129422","100780141  ","050","00","3","5","12065","12","065",12902,12743,159,74,85
"Lafayette County","Lafayette County, Florida","1405937770","13170086   ","050","00","3","5","12067","12","067",7022,6556,466,108,358
"Lake County","Lake County, Florida","2468647214","526411252  ","050","00","3","5","12069","12","069",210528,199708,10820,5084,5736
"Lee County","Lee County, Florida","2081393117","1057384871 ","050","00","3","5","12071","12","071",440888,400526,40362,15380,24982
"Leon County","Leon County, Florida","1726848272","90760963   ","050","00","3","5","12073","12","073",239452,228107,11345,4776,6569
"Levy County","Levy County, Florida","2896589908","761301417  ","050","00","3","5","12075","12","075",34450,33556,894,490,404
"Liberty County","Liberty County, Florida","2164882043","18891526   ","050","00","3","5","12077","12","077",7021,6875,146,49,97
"Madison County","Madison County, Florida","1791740566","62171851   ","050","00","3","5","12079","12","079",18733,18361,372,92,280
"Manatee County","Manatee County, Florida","1919250962","392948270  ","050","00","3","5","12081","12","081",264002,241767,22235,8466,13769
"Marion County","Marion County, Florida","4089224040","217955919  ","050","00","3","5","12083","12","083",258916,245564,13352,7516,5836
"Martin County","Martin County, Florida","1439037748","510686877  ","050","00","3","5","12085","12","085",126731,116413,10318,4482,5836
"Miami-Dade County","Miami-Dade County, Florida","5040281893","1256644967 ","050","00","3","5","12086","12","086",2253362,1105597,1147765,535080,612685
"Monroe County","Monroe County, Florida","2581997405","7097188635 ","050","00","3","5","12087","12","087",79589,67857,11732,5004,6728
"Nassau County","Nassau County, Florida","1687510883","192448901  ","050","00","3","5","12089","12","089",57663,56122,1541,666,875
"Okaloosa County","Okaloosa County, Florida","2423260572","379107044  ","050","00","3","5","12091","12","091",170498,161514,8984,5715,3269
"Okeechobee County","Okeechobee County, Florida","2004504057","304661835  ","050","00","3","5","12093","12","093",35910,31779,4131,1050,3081
"Orange County","Orange County, Florida","2350283150","250554236  ","050","00","3","5","12095","12","095",896344,767440,128904,53651,75253
"Osceola County","Osceola County, Florida","3423712812","477727771  ","050","00","3","5","12097","12","097",172493,148383,24110,9514,14596
"Palm Beach County","Palm Beach County, Florida","5112913099","1067653854 ","050","00","3","5","12099","12","099",1131184,934332,196852,83681,113171
"Pasco County","Pasco County, Florida","1929148020","318836906  ","050","00","3","5","12101","12","101",344765,320636,24129,13303,10826
"Pinellas County","Pinellas County, Florida","724980947","848878459  ","050","00","3","5","12103","12","103",921482,833797,87685,40786,46899
"Polk County","Polk County, Florida","4854625486","351212963  ","050","00","3","5","12105","12","105",483924,450405,33519,11908,21611
"Putnam County","Putnam County, Florida","1869686461","272651326  ","050","00","3","5","12107","12","107",70423,68052,2371,986,1385
"St. Johns County","St. Johns County, Florida","1577327360","550159510  ","050","00","3","5","12109","12","109",123135,117097,6038,3604,2434
"St. Lucie County","St. Lucie County, Florida","1482625971","299484165  ","050","00","3","5","12111","12","111",192695,172530,20165,8746,11419
"Santa Rosa County","Santa Rosa County, Florida","2633826493","405710830  ","050","00","3","5","12113","12","113",117743,114194,3549,2065,1484
"Sarasota County","Sarasota County, Florida","1480309966","397909102  ","050","00","3","5","12115","12","115",325957,295541,30416,14642,15774
"Seminole County","Seminole County, Florida","798244204","94967916   ","050","00","3","5","12117","12","117",365196,331911,33285,16507,16778
"Sumter County","Sumter County, Florida","1413432149","89572882   ","050","00","3","5","12119","12","119",53345,50407,2938,1163,1775
"Suwannee County","Suwannee County, Florida","1780979161","11028541   ","050","00","3","5","12121","12","121",34844,33213,1631,390,1241
"Taylor County","Taylor County, Florida","2698539748","492349029  ","050","00","3","5","12123","12","123",19256,18937,319,241,78
"Union County","Union County, Florida","622336384","24406640   ","050","00","3","5","12125","12","125",13442,13158,284,116,168
"Volusia County","Volusia County, Florida","2857403499","852587118  ","050","00","3","5","12127","12","127",443343,414990,28353,14955,13398
"Wakulla County","Wakulla County, Florida","1571240075","334318736  ","050","00","3","5","12129","12","129",22863,22529,334,184,150
"Walton County","Walton County, Florida","2739071253","467406411  ","050","00","3","5","12131","12","131",40601,39289,1312,663,649
"Washington County","Washington County, Florida","1502009565","92878415   ","050","00","3","5","12133","12","133",20973,20453,520,349,171
"Appling County","Appling County, Georgia","1317027712","9338010    ","050","00","3","5","13001","13","001",17419,16828,591,137,454
"Atkinson County","Atkinson County, Georgia","875528174","15679065   ","050","00","3","5","13003","13","003",7609,6692,917,153,764
"Bacon County","Bacon County, Georgia","738015457","2509334    ","050","00","3","5","13005","13","005",10103,9937,166,41,125
"Baker County","Baker County, Georgia","888935400","15408095   ","050","00","3","5","13007","13","007",4074,3996,78,28,50
"Baldwin County","Baldwin County, Georgia","669369760","23444397   ","050","00","3","5","13009","13","009",44700,43863,837,407,430
"Banks County","Banks County, Georgia","605204930","517217     ","050","00","3","5","13011","13","011",14422,14117,305,60,245
"Barrow County","Barrow County, Georgia","420019739","1734931    ","050","00","3","5","13013","13","013",46144,44464,1680,668,1012
"Bartow County","Bartow County, Georgia","1189906958","27677917   ","050","00","3","5","13015","13","015",76019,74085,1934,552,1382
"Ben Hill County","Ben Hill County, Georgia","652144451","5785209    ","050","00","3","5","13017","13","017",17484,16893,591,118,473
"Berrien County","Berrien County, Georgia","1171745138","13900427   ","050","00","3","5","13019","13","019",16235,16015,220,66,154
"Bibb County","Bibb County, Georgia","647399370","13387893   ","050","00","3","5","13021","13","021",153887,150990,2897,1234,1663
"Bleckley County","Bleckley County, Georgia","563050373","4511008    ","050","00","3","5","13023","13","023",11666,11499,167,73,94
"Brantley County","Brantley County, Georgia","1150992836","7810127    ","050","00","3","5","13025","13","025",14629,14502,127,41,86
"Brooks County","Brooks County, Georgia","1278473476","10740729   ","050","00","3","5","13027","13","027",16450,16170,280,93,187
"Bryan County","Bryan County, Georgia","1144024867","33097452   ","050","00","3","5","13029","13","029",23417,22825,592,281,311
"Bulloch County","Bulloch County, Georgia","1766557928","17524610   ","050","00","3","5","13031","13","031",55983,54254,1729,700,1029
"Burke County","Burke County, Georgia","2150910202","11700789   ","050","00","3","5","13033","13","033",22243,22056,187,123,64
"Butts County","Butts County, Georgia","483324085","8809350    ","050","00","3","5","13035","13","035",19522,19353,169,62,107
"Calhoun County","Calhoun County, Georgia","725665602","8777274    ","050","00","3","5","13037","13","037",6320,6200,120,78,42
"Camden County","Camden County, Georgia","1631466106","395263101  ","050","00","3","5","13039","13","039",43664,42649,1015,475,540
"Candler County","Candler County, Georgia","639404362","5017587    ","050","00","3","5","13043","13","043",9577,8991,586,95,491
"Carroll County","Carroll County, Georgia","1292230426","12674729   ","050","00","3","5","13045","13","045",87268,84697,2571,687,1884
"Catoosa County","Catoosa County, Georgia","420162010","1138014    ","050","00","3","5","13047","13","047",53282,52385,897,301,596
"Charlton County","Charlton County, Georgia","2022186864","5694136    ","050","00","3","5","13049","13","049",10282,10193,89,45,44
"Chatham County","Chatham County, Georgia","1134710329","502896640  ","050","00","3","5","13051","13","051",232048,222839,9209,3851,5358
"Chattahoochee County","Chattahoochee County, Georgia","644309946","6212093    ","050","00","3","5","13053","13","053",14882,13988,894,382,512
"Chattooga County","Chattooga County, Georgia","811515241","587717     ","050","00","3","5","13055","13","055",25470,24987,483,113,370
"Cherokee County","Cherokee County, Georgia","1097320817","26695297   ","050","00","3","5","13057","13","057",141903,133630,8273,2247,6026
"Clarke County","Clarke County, Georgia","312847519","1275394    ","050","00","3","5","13059","13","059",101489,92980,8509,1795,6714
"Clay County","Clay County, Georgia","505586964","56426278   ","050","00","3","5","13061","13","061",3357,3334,23,3,20
"Clayton County","Clayton County, Georgia","369388178","4293049    ","050","00","3","5","13063","13","063",236517,210628,25889,7841,18048
"Clinch County","Clinch County, Georgia","2096046195","38551013   ","050","00","3","5","13065","13","065",6878,6780,98,26,72
"Cobb County","Cobb County, Georgia","880984209","11292420   ","050","00","3","5","13067","13","067",607751,537312,70439,20701,49738
"Coffee County","Coffee County, Georgia","1551133471","9626248    ","050","00","3","5","13069","13","069",37413,35383,2030,524,1506
"Colquitt County","Colquitt County, Georgia","1430367856","11086913   ","050","00","3","5","13071","13","071",42053,39315,2738,291,2447
"Columbia County","Columbia County, Georgia","751134157","46005514   ","050","00","3","5","13073","13","073",89288,84984,4304,2632,1672
"Cook County","Cook County, Georgia","593153947","10886080   ","050","00","3","5","13075","13","075",15771,15406,365,125,240
"Coweta County","Coweta County, Georgia","1146372957","8704774    ","050","00","3","5","13077","13","077",89215,85958,3257,982,2275
"Crawford County","Crawford County, Georgia","841764778","3743382    ","050","00","3","5","13079","13","079",12495,12437,58,39,19
"Crisp County","Crisp County, Georgia","709186204","19108995   ","050","00","3","5","13081","13","081",21996,21528,468,94,374
"Dade County","Dade County, Georgia","450600975","469902     ","050","00","3","5","13083","13","083",15154,14936,218,74,144
"Dawson County","Dawson County, Georgia","546583978","7502633    ","050","00","3","5","13085","13","085",15999,15770,229,96,133
"Decatur County","Decatur County, Georgia","1545700986","68275469   ","050","00","3","5","13087","13","087",28240,27579,661,127,534
"DeKalb County","DeKalb County, Georgia","694649134","6998847    ","050","00","3","5","13089","13","089",665865,564545,101320,26531,74789
"Dodge County","Dodge County, Georgia","1295735235","7465229    ","050","00","3","5","13091","13","091",19171,18896,275,118,157
"Dooly County","Dooly County, Georgia","1017551127","10849212   ","050","00","3","5","13093","13","093",11525,11351,174,35,139
"Dougherty County","Dougherty County, Georgia","853658496","13051563   ","050","00","3","5","13095","13","095",96065,94399,1666,620,1046
"Douglas County","Douglas County, Georgia","516182640","2476542    ","050","00","3","5","13097","13","097",92174,88624,3550,1348,2202
"Early County","Early County, Georgia","1324085913","13048671   ","050","00","3","5","13099","13","099",12354,12262,92,19,73
"Echols County","Echols County, Georgia","1046682366","43180835   ","050","00","3","5","13101","13","101",3754,3281,473,54,419
"Effingham County","Effingham County, Georgia","1241677488","8817701    ","050","00","3","5","13103","13","103",37535,37033,502,270,232
"Elbert County","Elbert County, Georgia","955071595","14971054   ","050","00","3","5","13105","13","105",20511,20129,382,131,251
"Emanuel County","Emanuel County, Georgia","1776185016","11754659   ","050","00","3","5","13107","13","107",21837,20946,891,164,727
"Evans County","Evans County, Georgia","478943937","5072138    ","050","00","3","5","13109","13","109",10495,10040,455,61,394
"Fannin County","Fannin County, Georgia","999062000","14734795   ","050","00","3","5","13111","13","111",19798,19588,210,112,98
"Fayette County","Fayette County, Georgia","510355880","5697102    ","050","00","3","5","13113","13","113",91263,86657,4606,2146,2460
"Floyd County","Floyd County, Georgia","1329001018","13808242   ","050","00","3","5","13115","13","115",90565,85843,4722,1349,3373
"Forsyth County","Forsyth County, Georgia","584807414","55876126   ","050","00","3","5","13117","13","117",98407,92524,5883,1576,4307
"Franklin County","Franklin County, Georgia","681929947","7955593    ","050","00","3","5","13119","13","119",20285,20041,244,102,142
"Fulton County","Fulton County, Georgia","1369218041","15421403   ","050","00","3","5","13121","13","121",816006,737387,78619,21268,57351
"Gilmer County","Gilmer County, Georgia","1105114210","13322355   ","050","00","3","5","13123","13","123",23456,22104,1352,165,1187
"Glascock County","Glascock County, Georgia","373322474","804001     ","050","00","3","5","13125","13","125",2556,2556,0,0,0
"Glynn County","Glynn County, Georgia","1093928025","421657505  ","050","00","3","5","13127","13","127",67568,65324,2244,916,1328
"Gordon County","Gordon County, Georgia","920832558","6417197    ","050","00","3","5","13129","13","129",44104,41293,2811,415,2396
"Grady County","Grady County, Georgia","1186536922","5741618    ","050","00","3","5","13131","13","131",23659,22734,925,77,848
"Greene County","Greene County, Georgia","1005631089","46519241   ","050","00","3","5","13133","13","133",14406,14035,371,134,237
"Gwinnett County","Gwinnett County, Georgia","1120765173","10330244   ","050","00","3","5","13135","13","135",588448,488930,99518,29838,69680
"Habersham County","Habersham County, Georgia","720457202","2655014    ","050","00","3","5","13137","13","137",35902,33089,2813,632,2181
"Hall County","Hall County, Georgia","1019569684","92027130   ","050","00","3","5","13139","13","139",139277,116775,22502,3356,19146
"Hancock County","Hancock County, Georgia","1225799782","14187039   ","050","00","3","5","13141","13","141",10076,10045,31,18,13
"Haralson County","Haralson County, Georgia","730665981","2722186    ","050","00","3","5","13143","13","143",25690,25458,232,116,116
"Harris County","Harris County, Georgia","1200957325","23935358   ","050","00","3","5","13145","13","145",23695,23247,448,186,262
"Hart County","Hart County, Georgia","601418422","62702783   ","050","00","3","5","13147","13","147",22997,22706,291,160,131
"Heard County","Heard County, Georgia","766707720","13098708   ","050","00","3","5","13149","13","149",11012,10936,76,43,33
"Henry County","Henry County, Georgia","835819604","4575051    ","050","00","3","5","13151","13","151",119341,115296,4045,2206,1839
"Houston County","Houston County, Georgia","975779569","7966959    ","050","00","3","5","13153","13","153",110765,106992,3773,1737,2036
"Irwin County","Irwin County, Georgia","924128425","15329022   ","050","00","3","5","13155","13","155",9931,9806,125,19,106
"Jackson County","Jackson County, Georgia","886713334","1644714    ","050","00","3","5","13157","13","157",41589,40553,1036,310,726
"Jasper County","Jasper County, Georgia","959391323","8180918    ","050","00","3","5","13159","13","159",11426,11183,243,114,129
"Jeff Davis County","Jeff Davis County, Georgia","863463103","5279133    ","050","00","3","5","13161","13","161",12684,12202,482,81,401
"Jefferson County","Jefferson County, Georgia","1366607272","4943795    ","050","00","3","5","13163","13","163",17266,17175,91,31,60
"Jenkins County","Jenkins County, Georgia","905996073","6843779    ","050","00","3","5","13165","13","165",8575,8494,81,0,81
"Johnson County","Johnson County, Georgia","788037039","5842063    ","050","00","3","5","13167","13","167",8560,8544,16,5,11
"Jones County","Jones County, Georgia","1019799727","4254244    ","050","00","3","5","13169","13","169",23639,23407,232,79,153
"Lamar County","Lamar County, Georgia","478683917","2515258    ","050","00","3","5","13171","13","171",15912,15748,164,72,92
"Lanier County","Lanier County, Georgia","483873307","33685063   ","050","00","3","5","13173","13","173",7241,7164,77,21,56
"Laurens County","Laurens County, Georgia","2103767864","16155787   ","050","00","3","5","13175","13","175",44874,44368,506,189,317
"Lee County","Lee County, Georgia","921438960","16160130   ","050","00","3","5","13177","13","177",24757,24344,413,206,207
"Liberty County","Liberty County, Georgia","1344337505","216174828  ","050","00","3","5","13179","13","179",61610,58118,3492,1404,2088
"Lincoln County","Lincoln County, Georgia","546731047","119627466  ","050","00","3","5","13181","13","181",8348,8292,56,31,25
"Long County","Long County, Georgia","1038375404","6668719    ","050","00","3","5","13183","13","183",10304,9751,553,109,444
"Lowndes County","Lowndes County, Georgia","1305927264","16602714   ","050","00","3","5","13185","13","185",92115,89654,2461,1069,1392
"Lumpkin County","Lumpkin County, Georgia","736771861","1031831    ","050","00","3","5","13187","13","187",21016,20402,614,162,452
"McDuffie County","McDuffie County, Georgia","672808402","16899120   ","050","00","3","5","13189","13","189",21231,21096,135,64,71
"McIntosh County","McIntosh County, Georgia","1122627946","365385033  ","050","00","3","5","13191","13","191",10847,10743,104,80,24
"Macon County","Macon County, Georgia","1044500275","6906037    ","050","00","3","5","13193","13","193",14074,13821,253,35,218
"Madison County","Madison County, Georgia","735244939","4382980    ","050","00","3","5","13195","13","195",25730,25222,508,133,375
"Marion County","Marion County, Georgia","950523954","1279491    ","050","00","3","5","13197","13","197",7144,6790,354,51,303
"Meriwether County","Meriwether County, Georgia","1303494988","5335045    ","050","00","3","5","13199","13","199",22534,22371,163,57,106
"Miller County","Miller County, Georgia","733086780","1748419    ","050","00","3","5","13201","13","201",6383,6360,23,11,12
"Mitchell County","Mitchell County, Georgia","1325963353","4792956    ","050","00","3","5","13205","13","205",23932,23558,374,98,276
"Monroe County","Monroe County, Georgia","1024675743","5612119    ","050","00","3","5","13207","13","207",21757,21537,220,113,107
"Montgomery County","Montgomery County, Georgia","635389441","5154042    ","050","00","3","5","13209","13","209",8270,7945,325,59,266
"Morgan County","Morgan County, Georgia","905550810","12854379   ","050","00","3","5","13211","13","211",15457,15290,167,64,103
"Murray County","Murray County, Georgia","892021622","6392459    ","050","00","3","5","13213","13","213",36506,35185,1321,286,1035
"Muscogee County","Muscogee County, Georgia","560106351","12273208   ","050","00","3","5","13215","13","215",186291,177626,8665,4197,4468
"Newton County","Newton County, Georgia","715958451","7142945    ","050","00","3","5","13217","13","217",62001,60475,1526,706,820
"Oconee County","Oconee County, Georgia","480973488","1133955    ","050","00","3","5","13219","13","219",26225,25066,1159,439,720
"Oglethorpe County","Oglethorpe County, Georgia","1142472771","2742852    ","050","00","3","5","13221","13","221",12635,12528,107,53,54
"Paulding County","Paulding County, Georgia","811780741","4233552    ","050","00","3","5","13223","13","223",81678,79963,1715,766,949
"Peach County","Peach County, Georgia","391239596","1032378    ","050","00","3","5","13225","13","225",23668,22777,891,204,687
"Pickens County","Pickens County, Georgia","601210901","1681003    ","050","00","3","5","13227","13","227",22983,22530,453,128,325
"Pierce County","Pierce County, Georgia","889019723","1685972    ","050","00","3","5","13229","13","229",15636,15308,328,70,258
"Pike County","Pike County, Georgia","565586305","2734772    ","050","00","3","5","13231","13","231",13688,13550,138,41,97
"Polk County","Polk County, Georgia","805850175","2572981    ","050","00","3","5","13233","13","233",38127,35825,2302,500,1802
"Pulaski County","Pulaski County, Georgia","640823044","6391450    ","050","00","3","5","13235","13","235",9588,9336,252,32,220
"Putnam County","Putnam County, Georgia","892327693","41706037   ","050","00","3","5","13237","13","237",18812,18343,469,117,352
"Quitman County","Quitman County, Georgia","392495592","24288073   ","050","00","3","5","13239","13","239",2598,2579,19,7,12
"Rabun County","Rabun County, Georgia","961008648","15385167   ","050","00","3","5","13241","13","241",15050,14433,617,181,436
"Randolph County","Randolph County, Georgia","1111740855","4255508    ","050","00","3","5","13243","13","243",7791,7738,53,17,36
"Richmond County","Richmond County, Georgia","839251992","11432240   ","050","00","3","5","13245","13","245",199775,192984,6791,4024,2767
"Rockdale County","Rockdale County, Georgia","338332197","3877444    ","050","00","3","5","13247","13","247",70111,64750,5361,1361,4000
"Schley County","Schley County, Georgia","434098341","547891     ","050","00","3","5","13249","13","249",3766,3699,67,20,47
"Screven County","Screven County, Georgia","1679454296","18503827   ","050","00","3","5","13251","13","251",15374,15118,256,133,123
"Seminole County","Seminole County, Georgia","616516673","47978014   ","050","00","3","5","13253","13","253",9369,9270,99,26,73
"Spalding County","Spalding County, Georgia","512691349","4267816    ","050","00","3","5","13255","13","255",58417,57145,1272,325,947
"Stephens County","Stephens County, Georgia","464273383","12877539   ","050","00","3","5","13257","13","257",25435,25067,368,180,188
"Stewart County","Stewart County, Georgia","1188025171","11733568   ","050","00","3","5","13259","13","259",5252,5166,86,36,50
"Sumter County","Sumter County, Georgia","1256877305","18803133   ","050","00","3","5","13261","13","261",33200,32525,675,212,463
"Talbot County","Talbot County, Georgia","1018416278","3948522    ","050","00","3","5","13263","13","263",6498,6454,44,25,19
"Taliaferro County","Taliaferro County, Georgia","506054791","197627     ","050","00","3","5","13265","13","265",2077,2066,11,5,6
"Tattnall County","Tattnall County, Georgia","1252759764","11729696   ","050","00","3","5","13267","13","267",22305,21018,1287,309,978
"Taylor County","Taylor County, Georgia","977566155","5620795    ","050","00","3","5","13269","13","269",8815,8728,87,28,59
"Telfair County","Telfair County, Georgia","1142421448","7751572    ","050","00","3","5","13271","13","271",11794,11670,124,24,100
"Terrell County","Terrell County, Georgia","868600580","5851935    ","050","00","3","5","13273","13","273",10970,10785,185,95,90
"Thomas County","Thomas County, Georgia","1420100474","9777426    ","050","00","3","5","13275","13","275",42737,42122,615,294,321
"Tift County","Tift County, Georgia","686474357","9871959    ","050","00","3","5","13277","13","277",38407,36294,2113,365,1748
"Toombs County","Toombs County, Georgia","949616868","5159644    ","050","00","3","5","13279","13","279",26067,24535,1532,333,1199
"Towns County","Towns County, Georgia","431655083","13849053   ","050","00","3","5","13281","13","281",9319,9070,249,121,128
"Treutlen County","Treutlen County, Georgia","519708107","3964857    ","050","00","3","5","13283","13","283",6854,6726,128,52,76
"Troup County","Troup County, Georgia","1072008628","83023520   ","050","00","3","5","13285","13","285",58779,57614,1165,367,798
"Turner County","Turner County, Georgia","740808082","9906871    ","050","00","3","5","13287","13","287",9504,9273,231,77,154
"Twiggs County","Twiggs County, Georgia","933142151","6881116    ","050","00","3","5","13289","13","289",10590,10507,83,43,40
"Union County","Union County, Georgia","835397617","16768568   ","050","00","3","5","13291","13","291",17289,17066,223,174,49
"Upson County","Upson County, Georgia","842996575","5580060    ","050","00","3","5","13293","13","293",27597,27036,561,201,360
"Walker County","Walker County, Georgia","1156636353","1164775    ","050","00","3","5","13295","13","295",61053,60454,599,217,382
"Walton County","Walton County, Georgia","852571171","2262393    ","050","00","3","5","13297","13","297",60687,59493,1194,490,704
"Ware County","Ware County, Georgia","2336928831","10408357   ","050","00","3","5","13299","13","299",35483,34853,630,159,471
"Warren County","Warren County, Georgia","739498074","3149261    ","050","00","3","5","13301","13","301",6336,6307,29,13,16
"Washington County","Washington County, Georgia","1762073768","10442069   ","050","00","3","5","13303","13","303",21176,21065,111,48,63
"Wayne County","Wayne County, Georgia","1669667768","10704521   ","050","00","3","5","13305","13","305",26565,26155,410,175,235
"Webster County","Webster County, Georgia","542694470","1868733    ","050","00","3","5","13307","13","307",2390,2343,47,5,42
"Wheeler County","Wheeler County, Georgia","771080931","6277076    ","050","00","3","5","13309","13","309",6179,6061,118,12,106
"White County","White County, Georgia","625684363","1510192    ","050","00","3","5","13311","13","311",19944,19548,396,227,169
"Whitfield County","Whitfield County, Georgia","751057934","1718369    ","050","00","3","5","13313","13","313",83525,69630,13895,2103,11792
"Wilcox County","Wilcox County, Georgia","984962820","7768983    ","050","00","3","5","13315","13","315",8577,8505,72,15,57
"Wilkes County","Wilkes County, Georgia","1220854166","6789243    ","050","00","3","5","13317","13","317",10687,10550,137,43,94
"Wilkinson County","Wilkinson County, Georgia","1156576514","14114360   ","050","00","3","5","13319","13","319",10220,10076,144,36,108
"Worth County","Worth County, Georgia","1475586100","12577598   ","050","00","3","5","13321","13","321",21967,21758,209,84,125
"Hawaii County","Hawaii County, Hawaii","10432517539","2741985846 ","050","00","4","9","15001","15","001",148677,133469,15208,7839,7369
"Honolulu County","Honolulu County, Hawaii","1553387626","3955125860 ","050","00","4","9","15003","15","003",876156,707910,168246,102311,65935
"Kalawao County","Kalawao County, Hawaii","34201958","101319995  ","050","00","4","9","15005","15","005",147,117,30,30,0
"Kauai County","Kauai County, Hawaii","1612110222","1667768078 ","050","00","4","9","15007","15","007",58463,50889,7574,4806,2768
"Maui County","Maui County, Hawaii","3002303962","3210392559 ","050","00","4","9","15009","15","009",128094,106923,21171,12546,8625
"Ada County","Ada County, Idaho","2732414018","13822607   ","050","00","4","8","16001","16","001",300904,288040,12864,5116,7748
"Adams County","Adams County, Idaho","3534240016","14055584   ","050","00","4","8","16003","16","003",3476,3417,59,25,34
"Bannock County","Bannock County, Idaho","2883429627","88465277   ","050","00","4","8","16005","16","005",75565,73924,1641,815,826
"Bear Lake County","Bear Lake County, Idaho","2515865034","202159268  ","050","00","4","8","16007","16","007",6411,6339,72,26,46
"Benewah County","Benewah County, Idaho","2010008935","20487687   ","050","00","4","8","16009","16","009",9171,9112,59,32,27
"Bingham County","Bingham County, Idaho","5425336578","66059020   ","050","00","4","8","16011","16","011",41735,39201,2534,598,1936
"Blaine County","Blaine County, Idaho","6849954809","42059646   ","050","00","4","8","16013","16","013",18991,16976,2015,566,1449
"Boise County","Boise County, Idaho","4927348953","11146409   ","050","00","4","8","16015","16","015",6670,6510,160,60,100
"Bonner County","Bonner County, Idaho","4500542891","471181080  ","050","00","4","8","16017","16","017",36835,36089,746,428,318
"Bonneville County","Bonneville County, Idaho","4839334408","83335445   ","050","00","4","8","16019","16","019",82522,79306,3216,1170,2046
"Boundary County","Boundary County, Idaho","3286192758","24348657   ","050","00","4","8","16021","16","021",9871,9583,288,133,155
"Butte County","Butte County, Idaho","5783048305","1916981    ","050","00","4","8","16023","16","023",2899,2785,114,33,81
"Camas County","Camas County, Idaho","2784123824","10524748   ","050","00","4","8","16025","16","025",991,973,18,3,15
"Canyon County","Canyon County, Idaho","1527363178","35719112   ","050","00","4","8","16027","16","027",131441,120081,11360,3322,8038
"Caribou County","Caribou County, Idaho","4573948205","84466498   ","050","00","4","8","16029","16","029",7304,7172,132,37,95
"Cassia County","Cassia County, Idaho","6647063674","35897093   ","050","00","4","8","16031","16","031",21416,19849,1567,410,1157
"Clark County","Clark County, Idaho","4570381864","1503265    ","050","00","4","8","16033","16","033",1022,734,288,53,235
"Clearwater County","Clearwater County, Idaho","6375003321","69148734   ","050","00","4","8","16035","16","035",8930,8822,108,76,32
"Custer County","Custer County, Idaho","12756844014","29383068   ","050","00","4","8","16037","16","037",4342,4243,99,31,68
"Elmore County","Elmore County, Idaho","7970880683","59391627   ","050","00","4","8","16039","16","039",29130,26883,2247,752,1495
"Franklin County","Franklin County, Idaho","1723465364","7570284    ","050","00","4","8","16041","16","041",11329,10942,387,101,286
"Fremont County","Fremont County, Idaho","4834879096","74685583   ","050","00","4","8","16043","16","043",11819,10962,857,211,646
"Gem County","Gem County, Idaho","1457066871","8209994    ","050","00","4","8","16045","16","045",15181,14430,751,225,526
"Gooding County","Gooding County, Idaho","1892714019","7932216    ","050","00","4","8","16047","16","047",14155,12506,1649,334,1315
"Idaho County","Idaho County, Idaho","21975746856","45562903   ","050","00","4","8","16049","16","049",15511,15330,181,95,86
"Jefferson County","Jefferson County, Idaho","2836252504","27116238   ","050","00","4","8","16051","16","051",19155,18024,1131,234,897
"Jerome County","Jerome County, Idaho","1553568425","5263172    ","050","00","4","8","16053","16","053",18342,16407,1935,455,1480
"Kootenai County","Kootenai County, Idaho","3224845525","182773264  ","050","00","4","8","16055","16","055",108685,106087,2598,1464,1134
"Latah County","Latah County, Idaho","2788518961","616071     ","050","00","4","8","16057","16","057",34935,33450,1485,358,1127
"Lemhi County","Lemhi County, Idaho","11821116983","13843742   ","050","00","4","8","16059","16","059",7806,7688,118,63,55
"Lewis County","Lewis County, Idaho","1240715453","1983845    ","050","00","4","8","16061","16","061",3747,3705,42,23,19
"Lincoln County","Lincoln County, Idaho","3122302013","848289     ","050","00","4","8","16063","16","063",4044,3637,407,69,338
"Madison County","Madison County, Idaho","1221243194","4766279    ","050","00","4","8","16065","16","065",27467,26492,975,254,721
"Minidoka County","Minidoka County, Idaho","1967414867","8698549    ","050","00","4","8","16067","16","067",20174,17969,2205,539,1666
"Nez Perce County","Nez Perce County, Idaho","2199106991","18851831   ","050","00","4","8","16069","16","069",37410,36704,706,385,321
"Oneida County","Oneida County, Idaho","3108851426","3304581    ","050","00","4","8","16071","16","071",4125,4039,86,31,55
"Owyhee County","Owyhee County, Idaho","19885888661","48493695   ","050","00","4","8","16073","16","073",10644,9374,1270,284,986
"Payette County","Payette County, Idaho","1055465027","6913011    ","050","00","4","8","16075","16","075",20578,19446,1132,444,688
"Power County","Power County, Idaho","3640397464","95907049   ","050","00","4","8","16077","16","077",7538,6745,793,139,654
"Shoshone County","Shoshone County, Idaho","6821807921","4117464    ","050","00","4","8","16079","16","079",13771,13498,273,152,121
"Teton County","Teton County, Idaho","1166436540","539274     ","050","00","4","8","16081","16","081",5999,5403,596,106,490
"Twin Falls County","Twin Falls County, Idaho","4985793354","8917541    ","050","00","4","8","16083","16","083",64284,60181,4103,1353,2750
"Valley County","Valley County, Idaho","9525514622","144625558  ","050","00","4","8","16085","16","085",7651,7547,104,63,41
"Washington County","Washington County, Idaho","3771847470","44613238   ","050","00","4","8","16087","16","087",9977,9268,709,135,574
"Adams County","Adams County, Illinois","2218672126","37924714   ","050","00","2","3","17001","17","001",68277,67723,554,264,290
"Alexander County","Alexander County, Illinois","612225870","41845883   ","050","00","2","3","17003","17","003",9590,9506,84,53,31
"Bond County","Bond County, Illinois","984720341","6380583    ","050","00","2","3","17005","17","005",17633,17491,142,41,101
"Boone County","Boone County, Illinois","728473464","1751854    ","050","00","2","3","17007","17","007",41786,38672,3114,908,2206
"Brown County","Brown County, Illinois","791627134","4120069    ","050","00","2","3","17009","17","009",6950,6836,114,10,104
"Bureau County","Bureau County, Illinois","2249570413","12264509   ","050","00","2","3","17011","17","011",35503,34565,938,343,595
"Calhoun County","Calhoun County, Illinois","657379178","77365087   ","050","00","2","3","17013","17","013",5084,5031,53,38,15
"Carroll County","Carroll County, Illinois","1150503971","55830292   ","050","00","2","3","17015","17","015",16674,16354,320,145,175
"Cass County","Cass County, Illinois","973578443","20281035   ","050","00","2","3","17017","17","017",13695,12628,1067,208,859
"Champaign County","Champaign County, Illinois","2581715418","1881148    ","050","00","2","3","17019","17","019",179669,165280,14389,3936,10453
"Christian County","Christian County, Illinois","1836459714","17232565   ","050","00","2","3","17021","17","021",35372,34907,465,205,260
"Clark County","Clark County, Illinois","1298887932","8752855    ","050","00","2","3","17023","17","023",17008,16898,110,60,50
"Clay County","Clay County, Illinois","1215348986","1525520    ","050","00","2","3","17025","17","025",14560,14455,105,57,48
"Clinton County","Clinton County, Illinois","1228257056","75748972   ","050","00","2","3","17027","17","027",35535,35124,411,163,248
"Coles County","Coles County, Illinois","1316453530","4615587    ","050","00","2","3","17029","17","029",53196,52349,847,410,437
"Cook County","Cook County, Illinois","2449300798","1785436307 ","050","00","2","3","17031","17","031",5376741,4312038,1064703,420739,643964
"Crawford County","Crawford County, Illinois","1148749411","5708708    ","050","00","2","3","17033","17","033",20452,20180,272,95,177
"Cumberland County","Cumberland County, Illinois","896179057","2537976    ","050","00","2","3","17035","17","035",11253,11187,66,45,21
"DeKalb County","DeKalb County, Illinois","1642457595","2106707    ","050","00","2","3","17037","17","037",88969,83776,5193,1849,3344
"De Witt County","De Witt County, Illinois","1029716440","19628562   ","050","00","2","3","17039","17","039",16798,16596,202,101,101
"Douglas County","Douglas County, Illinois","1079667857","1442988    ","050","00","2","3","17041","17","041",19922,19423,499,128,371
"DuPage County","DuPage County, Illinois","864034248","7636291    ","050","00","2","3","17043","17","043",904161,765505,138656,61601,77055
"Edgar County","Edgar County, Illinois","1614999349","1632124    ","050","00","2","3","17045","17","045",19704,19593,111,76,35
"Edwards County","Edwards County, Illinois","575879274","797996     ","050","00","2","3","17047","17","047",6971,6944,27,17,10
"Effingham County","Effingham County, Illinois","1239826162","3115242    ","050","00","2","3","17049","17","049",34264,33921,343,122,221
"Fayette County","Fayette County, Illinois","1855693082","22975523   ","050","00","2","3","17051","17","051",21802,21709,93,48,45
"Ford County","Ford County, Illinois","1258473076","1339862    ","050","00","2","3","17053","17","053",14241,14091,150,82,68
"Franklin County","Franklin County, Illinois","1067269330","50043890   ","050","00","2","3","17055","17","055",39018,38752,266,156,110
"Fulton County","Fulton County, Illinois","2241955768","43952645   ","050","00","2","3","17057","17","057",38250,37942,308,167,141
"Gallatin County","Gallatin County, Illinois","838450715","12120660   ","050","00","2","3","17059","17","059",6445,6422,23,10,13
"Greene County","Greene County, Illinois","1406599772","8424874    ","050","00","2","3","17061","17","061",14761,14712,49,32,17
"Grundy County","Grundy County, Illinois","1087542889","27240335   ","050","00","2","3","17063","17","063",37535,36539,996,348,648
"Hamilton County","Hamilton County, Illinois","1127069640","1746467    ","050","00","2","3","17065","17","065",8621,8583,38,18,20
"Hancock County","Hancock County, Illinois","2058061147","51585223   ","050","00","2","3","17067","17","067",20121,20011,110,62,48
"Hardin County","Hardin County, Illinois","461881212","8287483    ","050","00","2","3","17069","17","069",4800,4725,75,13,62
"Henderson County","Henderson County, Illinois","981118459","42248329   ","050","00","2","3","17071","17","071",8213,8183,30,18,12
"Henry County","Henry County, Illinois","2132110339","6176134    ","050","00","2","3","17073","17","073",51020,50134,886,376,510
"Iroquois County","Iroquois County, Illinois","2891534000","4151211    ","050","00","2","3","17075","17","075",31334,30570,764,266,498
"Jackson County","Jackson County, Illinois","1523235581","37301738   ","050","00","2","3","17077","17","077",59612,56483,3129,630,2499
"Jasper County","Jasper County, Illinois","1280499931","9364378    ","050","00","2","3","17079","17","079",10117,10094,23,12,11
"Jefferson County","Jefferson County, Illinois","1478768461","33040991   ","050","00","2","3","17081","17","081",40045,39713,332,177,155
"Jersey County","Jersey County, Illinois","956113325","20361792   ","050","00","2","3","17083","17","083",21668,21460,208,91,117
"Jo Daviess County","Jo Daviess County, Illinois","1556790300","45674718   ","050","00","2","3","17085","17","085",22289,21921,368,147,221
"Johnson County","Johnson County, Illinois","892580171","11004603   ","050","00","2","3","17087","17","087",12878,12687,191,60,131
"Kane County","Kane County, Illinois","1347922501","9439462    ","050","00","2","3","17089","17","089",404119,340603,63516,18252,45264
"Kankakee County","Kankakee County, Illinois","1752772109","12162047   ","050","00","2","3","17091","17","091",103833,100222,3611,1532,2079
"Kendall County","Kendall County, Illinois","830294774","5414036    ","050","00","2","3","17093","17","093",54544,51645,2899,1451,1448
"Knox County","Knox County, Illinois","1855158547","8851277    ","050","00","2","3","17095","17","095",55836,54934,902,453,449
"Lake County","Lake County, Illinois","1159184623","2383790404 ","050","00","2","3","17097","17","097",644356,548820,95536,35300,60236
"La Salle County","La Salle County, Illinois","2939419691","33986314   ","050","00","2","3","17099","17","099",111509,108503,3006,1460,1546
"Lawrence County","Lawrence County, Illinois","963433244","5076462    ","050","00","2","3","17101","17","101",15452,15362,90,9,81
"Lee County","Lee County, Illinois","1878683655","10158806   ","050","00","2","3","17103","17","103",36062,35371,691,334,357
"Livingston County","Livingston County, Illinois","2703325383","4333369    ","050","00","2","3","17105","17","105",39678,39157,521,251,270
"Logan County","Logan County, Illinois","1600974150","2242885    ","050","00","2","3","17107","17","107",31183,30737,446,195,251
"McDonough County","McDonough County, Illinois","1526202798","1943173    ","050","00","2","3","17109","17","109",32913,31992,921,213,708
"McHenry County","McHenry County, Illinois","1563078834","19746035   ","050","00","2","3","17111","17","111",260077,241313,18764,7253,11511
"McLean County","McLean County, Illinois","3065321876","7143544    ","050","00","2","3","17113","17","113",150433,145455,4978,1729,3249
"Macon County","Macon County, Illinois","1503546813","12575217   ","050","00","2","3","17115","17","115",114706,113135,1571,753,818
"Macoupin County","Macoupin County, Illinois","2236646294","10458238   ","050","00","2","3","17117","17","117",49019,48770,249,168,81
"Madison County","Madison County, Illinois","1877788394","39709004   ","050","00","2","3","17119","17","119",258941,255655,3286,1811,1475
"Marion County","Marion County, Illinois","1482156493","8912592    ","050","00","2","3","17121","17","121",41691,41353,338,210,128
"Marshall County","Marshall County, Illinois","999896316","32253288   ","050","00","2","3","17123","17","123",13180,13048,132,79,53
"Mason County","Mason County, Illinois","1395854617","63263298   ","050","00","2","3","17125","17","125",16038,15976,62,41,21
"Massac County","Massac County, Illinois","619145951","7935615    ","050","00","2","3","17127","17","127",15161,15095,66,32,34
"Menard County","Menard County, Illinois","813896761","2916227    ","050","00","2","3","17129","17","129",12486,12401,85,44,41
"Mercer County","Mercer County, Illinois","1453046630","20355646   ","050","00","2","3","17131","17","131",16957,16852,105,46,59
"Monroe County","Monroe County, Illinois","1005671538","24392101   ","050","00","2","3","17133","17","133",27619,27387,232,156,76
"Montgomery County","Montgomery County, Illinois","1822821203","15424970   ","050","00","2","3","17135","17","135",30652,30390,262,156,106
"Morgan County","Morgan County, Illinois","1473074698","9083856    ","050","00","2","3","17137","17","137",36616,36206,410,187,223
"Moultrie County","Moultrie County, Illinois","869190483","22979514   ","050","00","2","3","17139","17","139",14287,14200,87,56,31
"Ogle County","Ogle County, Illinois","1965368722","11485500   ","050","00","2","3","17141","17","141",51032,48822,2210,839,1371
"Peoria County","Peoria County, Illinois","1604555696","29430618   ","050","00","2","3","17143","17","143",183433,177608,5825,2768,3057
"Perry County","Perry County, Illinois","1142083828","15153833   ","050","00","2","3","17145","17","145",23094,22870,224,100,124
"Piatt County","Piatt County, Illinois","1139651250","808703     ","050","00","2","3","17147","17","147",16365,16266,99,49,50
"Pike County","Pike County, Illinois","2150464165","48107632   ","050","00","2","3","17149","17","149",17384,17196,188,94,94
"Pope County","Pope County, Illinois","960531785","9776097    ","050","00","2","3","17151","17","151",4413,4384,29,4,25
"Pulaski County","Pulaski County, Illinois","520032959","6598181    ","050","00","2","3","17153","17","153",7348,7300,48,16,32
"Putnam County","Putnam County, Illinois","413868679","32235199   ","050","00","2","3","17155","17","155",6086,5975,111,59,52
"Randolph County","Randolph County, Illinois","1498090643","48799890   ","050","00","2","3","17157","17","157",33893,33614,279,110,169
"Richland County","Richland County, Illinois","932763611","4838953    ","050","00","2","3","17159","17","159",16149,16054,95,62,33
"Rock Island County","Rock Island County, Illinois","1105280677","63208511   ","050","00","2","3","17161","17","161",149374,142488,6886,2873,4013
"St. Clair County","St. Clair County, Illinois","1719253745","26278018   ","050","00","2","3","17163","17","163",256082,250639,5443,2743,2700
"Saline County","Saline County, Illinois","992766969","9496536    ","050","00","2","3","17165","17","165",26733,26538,195,122,73
"Sangamon County","Sangamon County, Illinois","2248581464","22855343   ","050","00","2","3","17167","17","167",188951,185414,3537,1928,1609
"Schuyler County","Schuyler County, Illinois","1132637582","10545936   ","050","00","2","3","17169","17","169",7189,7162,27,12,15
"Scott County","Scott County, Illinois","649869187","4791467    ","050","00","2","3","17171","17","171",5537,5512,25,10,15
"Shelby County","Shelby County, Illinois","1964534133","24712654   ","050","00","2","3","17173","17","173",22893,22792,101,73,28
"Stark County","Stark County, Illinois","745755535","714176     ","050","00","2","3","17175","17","175",6332,6304,28,20,8
"Stephenson County","Stephenson County, Illinois","1461230391","1388256    ","050","00","2","3","17177","17","177",48979,48058,921,371,550
"Tazewell County","Tazewell County, Illinois","1680540029","23393536   ","050","00","2","3","17179","17","179",128485,127030,1455,789,666
"Union County","Union County, Illinois","1077851694","15454421   ","050","00","2","3","17181","17","181",18293,17939,354,104,250
"Vermilion County","Vermilion County, Illinois","2328606541","7915927    ","050","00","2","3","17183","17","183",83919,82496,1423,646,777
"Wabash County","Wabash County, Illinois","578786625","11115526   ","050","00","2","3","17185","17","185",12937,12844,93,67,26
"Warren County","Warren County, Illinois","1405122319","1674618    ","050","00","2","3","17187","17","187",18735,18475,260,136,124
"Washington County","Washington County, Illinois","1457147214","3912917    ","050","00","2","3","17189","17","189",15148,15062,86,55,31
"Wayne County","Wayne County, Illinois","1848986002","4304987    ","050","00","2","3","17191","17","191",17151,16990,161,106,55
"White County","White County, Illinois","1281708431","17680413   ","050","00","2","3","17193","17","193",15371,15329,42,29,13
"Whiteside County","Whiteside County, Illinois","1773546391","31707117   ","050","00","2","3","17195","17","195",60653,58968,1685,680,1005
"Will County","Will County, Illinois","2167666114","32234514   ","050","00","2","3","17197","17","197",502266,466551,35715,15449,20266
"Williamson County","Williamson County, Illinois","1096636941","54291615   ","050","00","2","3","17199","17","199",61296,60645,651,371,280
"Winnebago County","Winnebago County, Illinois","1330572400","14340767   ","050","00","2","3","17201","17","201",278418,261488,16930,6160,10770
"Woodford County","Woodford County, Illinois","1367384872","38317003   ","050","00","2","3","17203","17","203",35469,35127,342,178,164
"Adams County","Adams County, Indiana","878938129","1485488    ","050","00","2","3","18001","18","001",33625,33265,360,221,139
"Allen County","Allen County, Indiana","1702268870","7388974    ","050","00","2","3","18003","18","003",331849,318455,13394,5235,8159
"Bartholomew County","Bartholomew County, Indiana","1053706192","6527955    ","050","00","2","3","18005","18","005",71435,68752,2683,720,1963
"Benton County","Benton County, Indiana","1052338649","236014     ","050","00","2","3","18007","18","007",9421,9347,74,64,10
"Blackford County","Blackford County, Indiana","427600367","790354     ","050","00","2","3","18009","18","009",14048,14029,19,9,10
"Boone County","Boone County, Indiana","1095183694","1097913    ","050","00","2","3","18011","18","011",46107,45424,683,269,414
"Brown County","Brown County, Indiana","808760520","11286879   ","050","00","2","3","18013","18","013",14957,14806,151,86,65
"Carroll County","Carroll County, Indiana","964143712","7243387    ","050","00","2","3","18015","18","015",20165,19730,435,125,310
"Cass County","Cass County, Indiana","1069323600","5323314    ","050","00","2","3","18017","18","017",40930,39167,1763,500,1263
"Clark County","Clark County, Indiana","971345543","3008476    ","050","00","2","3","18019","18","019",96472,94786,1686,695,991
"Clay County","Clay County, Indiana","926223832","7189285    ","050","00","2","3","18021","18","021",26556,26406,150,43,107
"Clinton County","Clinton County, Indiana","1049193310","468720     ","050","00","2","3","18023","18","023",33866,32253,1613,187,1426
"Crawford County","Crawford County, Indiana","791710530","8204002    ","050","00","2","3","18025","18","025",10743,10707,36,35,1
"Daviess County","Daviess County, Indiana","1115399472","16053700   ","050","00","2","3","18027","18","027",29820,29249,571,146,425
"Dearborn County","Dearborn County, Indiana","790496144","4759793    ","050","00","2","3","18029","18","029",46109,45728,381,219,162
"Decatur County","Decatur County, Indiana","965039242","2107040    ","050","00","2","3","18031","18","031",24555,24161,394,124,270
"DeKalb County","DeKalb County, Indiana","939849684","2501129    ","050","00","2","3","18033","18","033",40285,39963,322,135,187
"Delaware County","Delaware County, Indiana","1018621049","6819770    ","050","00","2","3","18035","18","035",118769,117015,1754,551,1203
"Dubois County","Dubois County, Indiana","1113917236","13317894   ","050","00","2","3","18037","18","037",39674,38846,828,196,632
"Elkhart County","Elkhart County, Indiana","1201271553","10448707   ","050","00","2","3","18039","18","039",182791,169809,12982,3072,9910
"Fayette County","Fayette County, Indiana","556750300","413786     ","050","00","2","3","18041","18","041",25588,25458,130,63,67
"Floyd County","Floyd County, Indiana","383314416","809536     ","050","00","2","3","18043","18","043",70823,69998,825,558,267
"Fountain County","Fountain County, Indiana","1024835884","5766410    ","050","00","2","3","18045","18","045",17954,17769,185,100,85
"Franklin County","Franklin County, Indiana","999742432","13812540   ","050","00","2","3","18047","18","047",22151,22008,143,102,41
"Fulton County","Fulton County, Indiana","954430483","7424213    ","050","00","2","3","18049","18","049",20511,20099,412,196,216
"Gibson County","Gibson County, Indiana","1265945055","26592852   ","050","00","2","3","18051","18","051",32500,32202,298,101,197
"Grant County","Grant County, Indiana","1072329368","2087962    ","050","00","2","3","18053","18","053",73403,72529,874,495,379
"Greene County","Greene County, Indiana","1403069250","10822532   ","050","00","2","3","18055","18","055",33157,33005,152,79,73
"Hamilton County","Hamilton County, Indiana","1030659443","12400138   ","050","00","2","3","18057","18","057",182740,175457,7283,3550,3733
"Hancock County","Hancock County, Indiana","792860060","1573047    ","050","00","2","3","18059","18","059",55391,54883,508,383,125
"Harrison County","Harrison County, Indiana","1256707048","4298352    ","050","00","2","3","18061","18","061",34325,34006,319,119,200
"Hendricks County","Hendricks County, Indiana","1057734962","1249174    ","050","00","2","3","18063","18","063",104093,102430,1663,856,807
"Henry County","Henry County, Indiana","1017676405","5101891    ","050","00","2","3","18065","18","065",48508,48249,259,168,91
"Howard County","Howard County, Indiana","759039097","2229896    ","050","00","2","3","18067","18","067",84964,83477,1487,708,779
"Huntington County","Huntington County, Indiana","990911815","13853095   ","050","00","2","3","18069","18","069",38075,37754,321,167,154
"Jackson County","Jackson County, Indiana","1319119215","11495954   ","050","00","2","3","18071","18","071",41335,40344,991,247,744
"Jasper County","Jasper County, Indiana","1450045348","3514142    ","050","00","2","3","18073","18","073",30043,29591,452,279,173
"Jay County","Jay County, Indiana","993614553","465184     ","050","00","2","3","18075","18","075",21806,21476,330,77,253
"Jefferson County","Jefferson County, Indiana","935931397","4081365    ","050","00","2","3","18077","18","077",31705,31324,381,178,203
"Jennings County","Jennings County, Indiana","977006491","2919492    ","050","00","2","3","18079","18","079",27554,27353,201,124,77
"Johnson County","Johnson County, Indiana","829297013","3531854    ","050","00","2","3","18081","18","081",115209,113238,1971,807,1164
"Knox County","Knox County, Indiana","1336004527","21294379   ","050","00","2","3","18083","18","083",39256,38826,430,137,293
"Kosciusko County","Kosciusko County, Indiana","1392125540","43602648   ","050","00","2","3","18085","18","085",74057,71915,2142,672,1470
"LaGrange County","LaGrange County, Indiana","983064819","18525491   ","050","00","2","3","18087","18","087",34909,34171,738,133,605
"Lake County","Lake County, Indiana","1287184722","335035775  ","050","00","2","3","18089","18","089",484564,458716,25848,14319,11529
"LaPorte County","LaPorte County, Indiana","1549429105","38336917   ","050","00","2","3","18091","18","091",110106,107376,2730,1464,1266
"Lawrence County","Lawrence County, Indiana","1162466015","8390544    ","050","00","2","3","18093","18","093",45922,45497,425,193,232
"Madison County","Madison County, Indiana","1171010928","2022316    ","050","00","2","3","18095","18","095",133358,131771,1587,540,1047
"Marion County","Marion County, Indiana","1026279857","17585955   ","050","00","2","3","18097","18","097",860454,821068,39386,13380,26006
"Marshall County","Marshall County, Indiana","1150665571","14633440   ","050","00","2","3","18099","18","099",45128,43130,1998,559,1439
"Martin County","Martin County, Indiana","870588814","11373992   ","050","00","2","3","18101","18","101",10369,10342,27,17,10
"Miami County","Miami County, Indiana","972849489","4512147    ","050","00","2","3","18103","18","103",36082,35737,345,208,137
"Monroe County","Monroe County, Indiana","1021351780","43955450   ","050","00","2","3","18105","18","105",120563,113997,6566,1785,4781
"Montgomery County","Montgomery County, Indiana","1306678230","2140304    ","050","00","2","3","18107","18","107",37629,37083,546,77,469
"Morgan County","Morgan County, Indiana","1052753734","7552456    ","050","00","2","3","18109","18","109",66689,66109,580,311,269
"Newton County","Newton County, Indiana","1040783341","4363716    ","050","00","2","3","18111","18","111",14566,14226,340,142,198
"Noble County","Noble County, Indiana","1064775038","16831334   ","050","00","2","3","18113","18","113",46275,44015,2260,579,1681
"Ohio County","Ohio County, Indiana","224612911","1934679    ","050","00","2","3","18115","18","115",5623,5617,6,6,0
"Orange County","Orange County, Indiana","1034754978","22482801   ","050","00","2","3","18117","18","117",19306,19148,158,43,115
"Owen County","Owen County, Indiana","997606598","6872342    ","050","00","2","3","18119","18","119",21786,21699,87,66,21
"Parke County","Parke County, Indiana","1151958364","13782456   ","050","00","2","3","18121","18","121",17241,17153,88,60,28
"Perry County","Perry County, Indiana","987805969","12812953   ","050","00","2","3","18123","18","123",18899,18821,78,37,41
"Pike County","Pike County, Indiana","870692004","12708620   ","050","00","2","3","18125","18","125",12837,12763,74,22,52
"Porter County","Porter County, Indiana","1082900386","268065565  ","050","00","2","3","18127","18","127",146798,142439,4359,2349,2010
"Posey County","Posey County, Indiana","1058010756","28353431   ","050","00","2","3","18129","18","129",27061,26931,130,50,80
"Pulaski County","Pulaski County, Indiana","1123214862","2317449    ","050","00","2","3","18131","18","131",13755,13647,108,27,81
"Putnam County","Putnam County, Indiana","1244000427","5887092    ","050","00","2","3","18133","18","133",36019,35630,389,127,262
"Randolph County","Randolph County, Indiana","1172831907","1016609    ","050","00","2","3","18135","18","135",27401,27201,200,51,149
"Ripley County","Ripley County, Indiana","1156068539","4024275    ","050","00","2","3","18137","18","137",26523,26344,179,60,119
"Rush County","Rush County, Indiana","1057447250","874562     ","050","00","2","3","18139","18","139",18261,18206,55,29,26
"St. Joseph County","St. Joseph County, Indiana","1184506795","9404250    ","050","00","2","3","18141","18","141",265559,253446,12113,4629,7484
"Scott County","Scott County, Indiana","493102309","6067249    ","050","00","2","3","18143","18","143",22960,22865,95,67,28
"Shelby County","Shelby County, Indiana","1068729086","1221371    ","050","00","2","3","18145","18","145",43445,42763,682,127,555
"Spencer County","Spencer County, Indiana","1032591768","6594621    ","050","00","2","3","18147","18","147",20391,20207,184,29,155
"Starke County","Starke County, Indiana","801110734","7776634    ","050","00","2","3","18149","18","149",23556,22937,619,311,308
"Steuben County","Steuben County, Indiana","799592091","35634757   ","050","00","2","3","18151","18","151",33214,32741,473,187,286
"Sullivan County","Sullivan County, Indiana","1158231746","17730783   ","050","00","2","3","18153","18","153",21751,21690,61,39,22
"Switzerland County","Switzerland County, Indiana","572856219","6061090    ","050","00","2","3","18155","18","155",9065,9020,45,18,27
"Tippecanoe County","Tippecanoe County, Indiana","1294454176","8493456    ","050","00","2","3","18157","18","157",148955,136788,12167,2430,9737
"Tipton County","Tipton County, Indiana","674395034","59501      ","050","00","2","3","18159","18","159",16577,16404,173,61,112
"Union County","Union County, Indiana","418407973","9583542    ","050","00","2","3","18161","18","161",7349,7321,28,23,5
"Vanderburgh County","Vanderburgh County, Indiana","607539458","3013556    ","050","00","2","3","18163","18","163",171922,169128,2794,1235,1559
"Vermillion County","Vermillion County, Indiana","665337903","7895535    ","050","00","2","3","18165","18","165",16788,16657,131,49,82
"Vigo County","Vigo County, Indiana","1044528005","18574943   ","050","00","2","3","18167","18","167",105848,103729,2119,759,1360
"Wabash County","Wabash County, Indiana","1070106158","20470741   ","050","00","2","3","18169","18","169",34960,34721,239,149,90
"Warren County","Warren County, Indiana","945042591","4447350    ","050","00","2","3","18171","18","171",8419,8392,27,8,19
"Warrick County","Warrick County, Indiana","994748387","17574343   ","050","00","2","3","18173","18","173",52383,51727,656,404,252
"Washington County","Washington County, Indiana","1332330769","5480035    ","050","00","2","3","18175","18","175",27223,27087,136,68,68
"Wayne County","Wayne County, Indiana","1045232235","2012939    ","050","00","2","3","18177","18","177",71097,70011,1086,424,662
"Wells County","Wells County, Indiana","958190248","1158035    ","050","00","2","3","18179","18","179",27600,27367,233,181,52
"White County","White County, Indiana","1308556440","9232269    ","050","00","2","3","18181","18","181",25267,24373,894,231,663
"Whitley County","Whitley County, Indiana","868990227","6167484    ","050","00","2","3","18183","18","183",30707,30451,256,122,134
"Adair County","Adair County, Iowa","1474485803","2599847    ","050","00","2","4","19001","19","001",8243,8187,56,28,28
"Adams County","Adams County, Iowa","1096962674","4832129    ","050","00","2","4","19003","19","003",4482,4471,11,11,0
"Allamakee County","Allamakee County, Iowa","1656463701","49583439   ","050","00","2","4","19005","19","005",14675,13863,812,96,716
"Appanoose County","Appanoose County, Iowa","1285285927","52046608   ","050","00","2","4","19007","19","007",13721,13581,140,50,90
"Audubon County","Audubon County, Iowa","1147703950","1151262    ","050","00","2","4","19009","19","009",6830,6783,47,39,8
"Benton County","Benton County, Iowa","1855438759","5339401    ","050","00","2","4","19011","19","011",25308,25149,159,102,57
"Black Hawk County","Black Hawk County, Iowa","1468819419","12421488   ","050","00","2","4","19013","19","013",128012,123233,4779,1499,3280
"Boone County","Boone County, Iowa","1480075104","5317536    ","050","00","2","4","19015","19","015",26224,26024,200,105,95
"Bremer County","Bremer County, Iowa","1134147372","4412753    ","050","00","2","4","19017","19","017",23325,23036,289,191,98
"Buchanan County","Buchanan County, Iowa","1479550983","5419814    ","050","00","2","4","19019","19","019",21093,20899,194,150,44
"Buena Vista County","Buena Vista County, Iowa","1488683322","13678254   ","050","00","2","4","19021","19","021",20411,17870,2541,587,1954
"Butler County","Butler County, Iowa","1503173518","3056661    ","050","00","2","4","19023","19","023",15305,15174,131,73,58
"Calhoun County","Calhoun County, Iowa","1476681388","5541547    ","050","00","2","4","19025","19","025",11115,11057,58,38,20
"Carroll County","Carroll County, Iowa","1474513028","2392571    ","050","00","2","4","19027","19","027",21421,21297,124,72,52
"Cass County","Cass County, Iowa","1461604630","1760610    ","050","00","2","4","19029","19","029",14684,14563,121,79,42
"Cedar County","Cedar County, Iowa","1500955175","6312027    ","050","00","2","4","19031","19","031",18187,18059,128,80,48
"Cerro Gordo County","Cerro Gordo County, Iowa","1471958543","17608293   ","050","00","2","4","19033","19","033",46447,45807,640,363,277
"Cherokee County","Cherokee County, Iowa","1494814098","478050     ","050","00","2","4","19035","19","035",13035,12917,118,68,50
"Chickasaw County","Chickasaw County, Iowa","1307020971","2176848    ","050","00","2","4","19037","19","037",13095,12976,119,54,65
"Clarke County","Clarke County, Iowa","1116584349","1553373    ","050","00","2","4","19039","19","039",9133,8902,231,41,190
"Clay County","Clay County, Iowa","1473410544","9394276    ","050","00","2","4","19041","19","041",17372,17055,317,118,199
"Clayton County","Clayton County, Iowa","2017101541","36270186   ","050","00","2","4","19043","19","043",18678,18460,218,77,141
"Clinton County","Clinton County, Iowa","1799990672","39396795   ","050","00","2","4","19045","19","045",50149,49469,680,292,388
"Crawford County","Crawford County, Iowa","1850193642","1632321    ","050","00","2","4","19047","19","047",16942,15903,1039,160,879
"Dallas County","Dallas County, Iowa","1518937313","13634041   ","050","00","2","4","19049","19","049",40750,39121,1629,388,1241
"Davis County","Davis County, Iowa","1303384628","4267092    ","050","00","2","4","19051","19","051",8541,8506,35,17,18
"Decatur County","Decatur County, Iowa","1377364917","3926620    ","050","00","2","4","19053","19","053",8689,8513,176,27,149
"Delaware County","Delaware County, Iowa","1496634003","3094320    ","050","00","2","4","19055","19","055",18404,18299,105,79,26
"Des Moines County","Des Moines County, Iowa","1077819498","35352273   ","050","00","2","4","19057","19","057",42351,41689,662,367,295
"Dickinson County","Dickinson County, Iowa","986939442","58602091   ","050","00","2","4","19059","19","059",16424,16308,116,76,40
"Dubuque County","Dubuque County, Iowa","1575117834","21773164   ","050","00","2","4","19061","19","061",89143,87488,1655,541,1114
"Emmet County","Emmet County, Iowa","1024968585","17180303   ","050","00","2","4","19063","19","063",11027,10777,250,72,178
"Fayette County","Fayette County, Iowa","1893085722","1348073    ","050","00","2","4","19065","19","065",22008,21773,235,120,115
"Floyd County","Floyd County, Iowa","1296456856","1927442    ","050","00","2","4","19067","19","067",16900,16706,194,60,134
"Franklin County","Franklin County, Iowa","1508499814","1483950    ","050","00","2","4","19069","19","069",10704,10232,472,102,370
"Fremont County","Fremont County, Iowa","1323690666","14700151   ","050","00","2","4","19071","19","071",8010,7877,133,47,86
"Greene County","Greene County, Iowa","1472167388","7047971    ","050","00","2","4","19073","19","073",10366,10241,125,44,81
"Grundy County","Grundy County, Iowa","1301504402","83861      ","050","00","2","4","19075","19","075",12369,12274,95,64,31
"Guthrie County","Guthrie County, Iowa","1529649618","6361095    ","050","00","2","4","19077","19","077",11353,11221,132,58,74
"Hamilton County","Hamilton County, Iowa","1493594242","1980074    ","050","00","2","4","19079","19","079",16438,16089,349,97,252
"Hancock County","Hancock County, Iowa","1479168162","5269077    ","050","00","2","4","19081","19","081",12100,11831,269,104,165
"Hardin County","Hardin County, Iowa","1474369884","1748575    ","050","00","2","4","19083","19","083",18812,18489,323,126,197
"Harrison County","Harrison County, Iowa","1804503600","10886585   ","050","00","2","4","19085","19","085",15666,15542,124,50,74
"Henry County","Henry County, Iowa","1125187417","5797310    ","050","00","2","4","19087","19","087",20336,19967,369,210,159
"Howard County","Howard County, Iowa","1226106949","927974     ","050","00","2","4","19089","19","089",9932,9896,36,26,10
"Humboldt County","Humboldt County, Iowa","1125119979","3405680    ","050","00","2","4","19091","19","091",10381,10238,143,50,93
"Ida County","Ida County, Iowa","1118112305","1346648    ","050","00","2","4","19093","19","093",7837,7819,18,14,4
"Iowa County","Iowa County, Iowa","1518895271","2325666    ","050","00","2","4","19095","19","095",15671,15548,123,76,47
"Jackson County","Jackson County, Iowa","1647464010","35378745   ","050","00","2","4","19097","19","097",20296,20147,149,91,58
"Jasper County","Jasper County, Iowa","1890661231","7608012    ","050","00","2","4","19099","19","099",37213,36665,548,213,335
"Jefferson County","Jefferson County, Iowa","1127527476","3563874    ","050","00","2","4","19101","19","101",16181,15541,640,132,508
"Johnson County","Johnson County, Iowa","1591493741","22974641   ","050","00","2","4","19103","19","103",111006,103908,7098,1946,5152
"Jones County","Jones County, Iowa","1490042057","3604321    ","050","00","2","4","19105","19","105",20221,20061,160,49,111
"Keokuk County","Keokuk County, Iowa","1500089075","1941795    ","050","00","2","4","19107","19","107",11400,11355,45,25,20
"Kossuth County","Kossuth County, Iowa","2520072916","3585163    ","050","00","2","4","19109","19","109",17163,17013,150,87,63
"Lee County","Lee County, Iowa","1340040200","55355227   ","050","00","2","4","19111","19","111",38052,37626,426,196,230
"Linn County","Linn County, Iowa","1858167132","18398683   ","050","00","2","4","19113","19","113",191701,186767,4934,2002,2932
"Louisa County","Louisa County, Iowa","1040960153","40735233   ","050","00","2","4","19115","19","115",12183,11359,824,247,577
"Lucas County","Lucas County, Iowa","1115115339","9392512    ","050","00","2","4","19117","19","117",9422,9358,64,27,37
"Lyon County","Lyon County, Iowa","1521620172","347269     ","050","00","2","4","19119","19","119",11763,11652,111,71,40
"Madison County","Madison County, Iowa","1453335230","3004689    ","050","00","2","4","19121","19","121",14019,13934,85,56,29
"Mahaska County","Mahaska County, Iowa","1478547734","6552029    ","050","00","2","4","19123","19","123",22335,21985,350,108,242
"Marion County","Marion County, Iowa","1435407880","42269737   ","050","00","2","4","19125","19","125",32052,31520,532,348,184
"Marshall County","Marshall County, Iowa","1482292782","1809376    ","050","00","2","4","19127","19","127",39311,36716,2595,576,2019
"Mills County","Mills County, Iowa","1130616543","8119401    ","050","00","2","4","19129","19","129",14547,14408,139,67,72
"Mitchell County","Mitchell County, Iowa","1214503073","1226604    ","050","00","2","4","19131","19","131",10874,10815,59,50,9
"Monona County","Monona County, Iowa","1795160988","14842528   ","050","00","2","4","19133","19","133",10020,9976,44,29,15
"Monroe County","Monroe County, Iowa","1122514792","1813400    ","050","00","2","4","19135","19","135",8016,7968,48,37,11
"Montgomery County","Montgomery County, Iowa","1097848242","2412232    ","050","00","2","4","19137","19","137",11771,11624,147,43,104
"Muscatine County","Muscatine County, Iowa","1136146756","26935827   ","050","00","2","4","19139","19","139",41722,39266,2456,991,1465
"O'Brien County","O'Brien County, Iowa","1484265528","443388     ","050","00","2","4","19141","19","141",15102,14802,300,132,168
"Osceola County","Osceola County, Iowa","1032816585","1836838    ","050","00","2","4","19143","19","143",7003,6920,83,36,47
"Page County","Page County, Iowa","1385188241","1359121    ","050","00","2","4","19145","19","145",16976,16814,162,96,66
"Palo Alto County","Palo Alto County, Iowa","1460316904","14423970   ","050","00","2","4","19147","19","147",10147,10055,92,48,44
"Plymouth County","Plymouth County, Iowa","2236621237","1020382    ","050","00","2","4","19149","19","149",24849,24551,298,116,182
"Pocahontas County","Pocahontas County, Iowa","1496240975","3688856    ","050","00","2","4","19151","19","151",8662,8584,78,36,42
"Polk County","Polk County, Iowa","1474600546","58414140   ","050","00","2","4","19153","19","153",374601,352439,22162,7072,15090
"Pottawattamie County","Pottawattamie County, Iowa","2471527702","14705551   ","050","00","2","4","19155","19","155",87704,85927,1777,776,1001
"Poweshiek County","Poweshiek County, Iowa","1515232882","2948468    ","050","00","2","4","19157","19","157",18815,18417,398,194,204
"Ringgold County","Ringgold County, Iowa","1392547781","3256488    ","050","00","2","4","19159","19","159",5469,5443,26,18,8
"Sac County","Sac County, Iowa","1491373754","6634728    ","050","00","2","4","19161","19","161",11529,11374,155,64,91
"Scott County","Scott County, Iowa","1186043898","26522530   ","050","00","2","4","19163","19","163",158668,153812,4856,2064,2792
"Shelby County","Shelby County, Iowa","1530243402","1390822    ","050","00","2","4","19165","19","165",13173,13090,83,55,28
"Sioux County","Sioux County, Iowa","1988808569","1811107    ","050","00","2","4","19167","19","167",31589,30669,920,284,636
"Story County","Story County, Iowa","1483700745","2168471    ","050","00","2","4","19169","19","169",79981,74444,5537,935,4602
"Tama County","Tama County, Iowa","1868152958","2769405    ","050","00","2","4","19171","19","171",18103,17742,361,141,220
"Taylor County","Taylor County, Iowa","1382931664","2261204    ","050","00","2","4","19173","19","173",6958,6816,142,43,99
"Union County","Union County, Iowa","1099156431","4057826    ","050","00","2","4","19175","19","175",12309,12196,113,60,53
"Van Buren County","Van Buren County, Iowa","1255673956","14843032   ","050","00","2","4","19177","19","177",7809,7760,49,33,16
"Wapello County","Wapello County, Iowa","1118379166","10809775   ","050","00","2","4","19179","19","179",36051,35372,679,202,477
"Warren County","Warren County, Iowa","1480551159","4047522    ","050","00","2","4","19181","19","181",40671,40211,460,269,191
"Washington County","Washington County, Iowa","1472959757","5324980    ","050","00","2","4","19183","19","183",20670,20360,310,82,228
"Wayne County","Wayne County, Iowa","1361309033","3825099    ","050","00","2","4","19185","19","185",6730,6691,39,22,17
"Webster County","Webster County, Iowa","1852449097","7296287    ","050","00","2","4","19187","19","187",40235,39439,796,352,444
"Winnebago County","Winnebago County, Iowa","1037203684","2859723    ","050","00","2","4","19189","19","189",11723,11508,215,22,193
"Winneshiek County","Winneshiek County, Iowa","1786080294","698582     ","050","00","2","4","19191","19","191",21310,20863,447,112,335
"Woodbury County","Woodbury County, Iowa","2260009199","12408837   ","050","00","2","4","19193","19","193",103877,96362,7515,1921,5594
"Worth County","Worth County, Iowa","1035987843","4437166    ","050","00","2","4","19195","19","195",7909,7824,85,46,39
"Wright County","Wright County, Iowa","1504065286","4704103    ","050","00","2","4","19197","19","197",14334,13911,423,141,282
"Allen County","Allen County, Kansas","1302781243","5634828    ","050","00","2","4","20001","20","001",14385,14254,131,47,84
"Anderson County","Anderson County, Kansas","1509750043","3566169    ","050","00","2","4","20003","20","003",8110,8063,47,15,32
"Atchison County","Atchison County, Kansas","1119749578","7004395    ","050","00","2","4","20005","20","005",16774,16662,112,62,50
"Barber County","Barber County, Kansas","2937337841","5434284    ","050","00","2","4","20007","20","007",5307,5283,24,10,14
"Barton County","Barton County, Kansas","2315459321","16732561   ","050","00","2","4","20009","20","009",28205,26959,1246,247,999
"Bourbon County","Bourbon County, Kansas","1650049295","4491922    ","050","00","2","4","20011","20","011",15379,15276,103,36,67
"Brown County","Brown County, Kansas","1478039918","3941157    ","050","00","2","4","20013","20","013",10724,10589,135,76,59
"Butler County","Butler County, Kansas","3698114920","48104175   ","050","00","2","4","20015","20","015",59482,58693,789,342,447
"Chase County","Chase County, Kansas","2009538213","5496332    ","050","00","2","4","20017","20","017",3030,2997,33,11,22
"Chautauqua County","Chautauqua County, Kansas","1661959586","8136639    ","050","00","2","4","20019","20","019",4359,4324,35,16,19
"Cherokee County","Cherokee County, Kansas","1520621277","9970872    ","050","00","2","4","20021","20","021",22605,22417,188,100,88
"Cheyenne County","Cheyenne County, Kansas","2641489340","2462666    ","050","00","2","4","20023","20","023",3165,3087,78,14,64
"Clark County","Clark County, Kansas","2524419575","6529191    ","050","00","2","4","20025","20","025",2390,2322,68,14,54
"Clay County","Clay County, Kansas","1667542397","30042743   ","050","00","2","4","20027","20","027",8822,8737,85,34,51
"Cloud County","Cloud County, Kansas","1853483448","7349470    ","050","00","2","4","20029","20","029",10268,10126,142,72,70
"Coffey County","Coffey County, Kansas","1631034448","64293466   ","050","00","2","4","20031","20","031",8865,8795,70,28,42
"Comanche County","Comanche County, Kansas","2041721350","3594942    ","050","00","2","4","20033","20","033",1967,1946,21,6,15
"Cowley County","Cowley County, Kansas","2916939456","16488639   ","050","00","2","4","20035","20","035",36291,35389,902,279,623
"Crawford County","Crawford County, Kansas","1535622965","5542090    ","050","00","2","4","20037","20","037",38242,37202,1040,281,759
"Decatur County","Decatur County, Kansas","2314271489","1641535    ","050","00","2","4","20039","20","039",3472,3429,43,13,30
"Dickinson County","Dickinson County, Kansas","2196108890","10873288   ","050","00","2","4","20041","20","041",19344,19023,321,196,125
"Doniphan County","Doniphan County, Kansas","1015734591","12663918   ","050","00","2","4","20043","20","043",8249,8186,63,34,29
"Douglas County","Douglas County, Kansas","1183288922","45585042   ","050","00","2","4","20045","20","045",99962,94794,5168,1452,3716
"Edwards County","Edwards County, Kansas","1611011662","208564     ","050","00","2","4","20047","20","047",3449,3219,230,36,194
"Elk County","Elk County, Kansas","1676482330","7954931    ","050","00","2","4","20049","20","049",3261,3238,23,4,19
"Ellis County","Ellis County, Kansas","2330913217","1298849    ","050","00","2","4","20051","20","051",27507,26864,643,140,503
"Ellsworth County","Ellsworth County, Kansas","1854187306","19522808   ","050","00","2","4","20053","20","053",6525,6438,87,34,53
"Finney County","Finney County, Kansas","3371579845","2177526    ","050","00","2","4","20055","20","055",40523,31330,9193,2313,6880
"Ford County","Ford County, Kansas","2845096923","2041426    ","050","00","2","4","20057","20","057",32458,25141,7317,1372,5945
"Franklin County","Franklin County, Kansas","1486273778","7251460    ","050","00","2","4","20059","20","059",24784,24466,318,138,180
"Geary County","Geary County, Kansas","996351852","51023311   ","050","00","2","4","20061","20","061",27947,25914,2033,1190,843
"Gove County","Gove County, Kansas","2774871632","234107     ","050","00","2","4","20063","20","063",3068,3054,14,6,8
"Graham County","Graham County, Kansas","2326550146","995923     ","050","00","2","4","20065","20","065",2946,2919,27,22,5
"Grant County","Grant County, Kansas","1488871976","473370     ","050","00","2","4","20067","20","067",7909,6939,970,328,642
"Gray County","Gray County, Kansas","2250443051","1139302    ","050","00","2","4","20069","20","069",5904,5341,563,93,470
"Greeley County","Greeley County, Kansas","2015024746","0          ","050","00","2","4","20071","20","071",1534,1403,131,10,121
"Greenwood County","Greenwood County, Kansas","2951724374","33461945   ","050","00","2","4","20073","20","073",7673,7593,80,31,49
"Hamilton County","Hamilton County, Kansas","2580902700","2924215    ","050","00","2","4","20075","20","075",2670,2310,360,57,303
"Harper County","Harper County, Kansas","2075716613","3918261    ","050","00","2","4","20077","20","077",6536,6508,28,8,20
"Harvey County","Harvey County, Kansas","1396866280","3033892    ","050","00","2","4","20079","20","079",32869,31644,1225,427,798
"Haskell County","Haskell County, Kansas","1495369685","933940     ","050","00","2","4","20081","20","081",4307,3731,576,198,378
"Hodgeman County","Hodgeman County, Kansas","2227189726","822887     ","050","00","2","4","20083","20","083",2085,2064,21,0,21
"Jackson County","Jackson County, Kansas","1697979968","5871859    ","050","00","2","4","20085","20","085",12657,12595,62,31,31
"Jefferson County","Jefferson County, Kansas","1388524630","53953277   ","050","00","2","4","20087","20","087",18426,18317,109,36,73
"Jewell County","Jewell County, Kansas","2354761450","13707389   ","050","00","2","4","20089","20","089",3791,3758,33,9,24
"Johnson County","Johnson County, Kansas","1234844210","8725636    ","050","00","2","4","20091","20","091",451086,425555,25531,10528,15003
"Kearny County","Kearny County, Kansas","2256033735","1150620    ","050","00","2","4","20093","20","093",4531,3957,574,132,442
"Kingman County","Kingman County, Kansas","2236057212","8683175    ","050","00","2","4","20095","20","095",8673,8643,30,11,19
"Kiowa County","Kiowa County, Kansas","1870992717","596751     ","050","00","2","4","20097","20","097",3278,3217,61,12,49
"Labette County","Labette County, Kansas","1680441611","11599938   ","050","00","2","4","20099","20","099",22835,22609,226,136,90
"Lane County","Lane County, Kansas","1857584983","551138     ","050","00","2","4","20101","20","101",2155,2144,11,8,3
"Leavenworth County","Leavenworth County, Kansas","1199868696","13099909   ","050","00","2","4","20103","20","103",68691,66861,1830,1020,810
"Lincoln County","Lincoln County, Kansas","1861861931","2771159    ","050","00","2","4","20105","20","105",3578,3559,19,12,7
"Linn County","Linn County, Kansas","1550547739","19734736   ","050","00","2","4","20107","20","107",9570,9544,26,17,9
"Logan County","Logan County, Kansas","2779023781","274630     ","050","00","2","4","20109","20","109",3046,3028,18,10,8
"Lyon County","Lyon County, Kansas","2203740728","11051416   ","050","00","2","4","20111","20","111",35935,32688,3247,611,2636
"McPherson County","McPherson County, Kansas","2330241609","3949362    ","050","00","2","4","20113","20","113",29554,29388,166,64,102
"Marion County","Marion County, Kansas","2442636621","27019123   ","050","00","2","4","20115","20","115",13361,13210,151,98,53
"Marshall County","Marshall County, Kansas","2337543745","4737021    ","050","00","2","4","20117","20","117",10965,10843,122,87,35
"Meade County","Meade County, Kansas","2534086363","3215224    ","050","00","2","4","20119","20","119",4631,4220,411,92,319
"Miami County","Miami County, Kansas","1493696732","34786706   ","050","00","2","4","20121","20","121",28351,28189,162,89,73
"Mitchell County","Mitchell County, Kansas","1812530696","48695029   ","050","00","2","4","20123","20","123",6932,6908,24,10,14
"Montgomery County","Montgomery County, Kansas","1671069601","16039269   ","050","00","2","4","20125","20","125",36252,35777,475,209,266
"Morris County","Morris County, Kansas","1806201846","14134170   ","050","00","2","4","20127","20","127",6104,6014,90,33,57
"Morton County","Morton County, Kansas","1890483871","54721      ","050","00","2","4","20129","20","129",3496,3165,331,103,228
"Nemaha County","Nemaha County, Kansas","1859578740","3654535    ","050","00","2","4","20131","20","131",10717,10671,46,23,23
"Neosho County","Neosho County, Kansas","1480820514","16246860   ","050","00","2","4","20133","20","133",16997,16883,114,58,56
"Ness County","Ness County, Kansas","2783581074","667310     ","050","00","2","4","20135","20","135",3454,3424,30,11,19
"Norton County","Norton County, Kansas","2273602126","9184461    ","050","00","2","4","20137","20","137",5953,5919,34,24,10
"Osage County","Osage County, Kansas","1822066478","40718711   ","050","00","2","4","20139","20","139",16712,16611,101,69,32
"Osborne County","Osborne County, Kansas","2311276912","4896621    ","050","00","2","4","20141","20","141",4452,4422,30,15,15
"Ottawa County","Ottawa County, Kansas","1867669100","2034610    ","050","00","2","4","20143","20","143",6163,6118,45,22,23
"Pawnee County","Pawnee County, Kansas","1953299131","992024     ","050","00","2","4","20145","20","145",7233,7132,101,74,27
"Phillips County","Phillips County, Kansas","2295321354","22228588   ","050","00","2","4","20147","20","147",6001,5978,23,15,8
"Pottawatomie County","Pottawatomie County, Kansas","2186569613","46177450   ","050","00","2","4","20149","20","149",18209,18026,183,88,95
"Pratt County","Pratt County, Kansas","1903617696","1979501    ","050","00","2","4","20151","20","151",9647,9530,117,48,69
"Rawlins County","Rawlins County, Kansas","2770293240","280961     ","050","00","2","4","20153","20","153",2966,2955,11,9,2
"Reno County","Reno County, Kansas","3248928230","43603282   ","050","00","2","4","20155","20","155",64790,63522,1268,581,687
"Republic County","Republic County, Kansas","1855423684","10178177   ","050","00","2","4","20157","20","157",5835,5789,46,36,10
"Rice County","Rice County, Kansas","1881827679","4450034    ","050","00","2","4","20159","20","159",10761,10521,240,28,212
"Riley County","Riley County, Kansas","1578728051","32516685   ","050","00","2","4","20161","20","161",62843,58989,3854,1152,2702
"Rooks County","Rooks County, Kansas","2300801183","18174436   ","050","00","2","4","20163","20","163",5685,5671,14,12,2
"Rush County","Rush County, Kansas","1860148723","544865     ","050","00","2","4","20165","20","165",3551,3534,17,17,0
"Russell County","Russell County, Kansas","2291311584","37047136   ","050","00","2","4","20167","20","167",7370,7321,49,18,31
"Saline County","Saline County, Kansas","1863789025","4315448    ","050","00","2","4","20169","20","169",53597,51436,2161,900,1261
"Scott County","Scott County, Kansas","1858380253","304731     ","050","00","2","4","20171","20","171",5120,4987,133,40,93
"Sedgwick County","Sedgwick County, Kansas","2588371255","25988729   ","050","00","2","4","20173","20","173",452869,422798,30071,11250,18821
"Seward County","Seward County, Kansas","1656356746","2562618    ","050","00","2","4","20175","20","175",22510,16340,6170,1407,4763
"Shawnee County","Shawnee County, Kansas","1424015086","16835524   ","050","00","2","4","20177","20","177",169871,165317,4554,1711,2843
"Sheridan County","Sheridan County, Kansas","2321551000","647643     ","050","00","2","4","20179","20","179",2813,2801,12,7,5
"Sherman County","Sherman County, Kansas","2734511928","548250     ","050","00","2","4","20181","20","181",6760,6641,119,69,50
"Smith County","Smith County, Kansas","2319155240","2838829    ","050","00","2","4","20183","20","183",4536,4507,29,23,6
"Stafford County","Stafford County, Kansas","2051409369","6915466    ","050","00","2","4","20185","20","185",4789,4615,174,45,129
"Stanton County","Stanton County, Kansas","1761203284","147268     ","050","00","2","4","20187","20","187",2406,2101,305,54,251
"Stevens County","Stevens County, Kansas","1884289606","463605     ","050","00","2","4","20189","20","189",5463,4806,657,265,392
"Sumner County","Sumner County, Kansas","3060863993","7712942    ","050","00","2","4","20191","20","191",25946,25728,218,148,70
"Thomas County","Thomas County, Kansas","2783679450","288228     ","050","00","2","4","20193","20","193",8180,8147,33,21,12
"Trego County","Trego County, Kansas","2300669030","27792003   ","050","00","2","4","20195","20","195",3319,3301,18,15,3
"Wabaunsee County","Wabaunsee County, Kansas","2065207345","6253071    ","050","00","2","4","20197","20","197",6885,6834,51,25,26
"Wallace County","Wallace County, Kansas","2367233016","136475     ","050","00","2","4","20199","20","199",1749,1710,39,10,29
"Washington County","Washington County, Kansas","2326996076","981695     ","050","00","2","4","20201","20","201",6483,6451,32,8,24
"Wichita County","Wichita County, Kansas","1860951277","61986      ","050","00","2","4","20203","20","203",2531,2328,203,52,151
"Wilson County","Wilson County, Kansas","1486156996","3019101    ","050","00","2","4","20205","20","205",10332,10275,57,34,23
"Woodson County","Woodson County, Kansas","1296562465","12549925   ","050","00","2","4","20207","20","207",3788,3758,30,30,0
"Wyandotte County","Wyandotte County, Kansas","392097572","11140433   ","050","00","2","4","20209","20","209",157882,142928,14954,3199,11755
"Adair County","Adair County, Kentucky","1053704499","13969617   ","050","00","3","6","21001","21","001",17244,17142,102,13,89
"Allen County","Allen County, Kentucky","896450919","15330656   ","050","00","3","6","21003","21","003",17800,17665,135,51,84
"Anderson County","Anderson County, Kentucky","524913106","4177657    ","050","00","3","6","21005","21","005",19111,18947,164,103,61
"Ballard County","Ballard County, Kentucky","650503463","58120830   ","050","00","3","6","21007","21","007",8286,8216,70,20,50
"Barren County","Barren County, Kentucky","1271616528","23194002   ","050","00","3","6","21009","21","009",38033,37595,438,186,252
"Bath County","Bath County, Kentucky","723793989","11615891   ","050","00","3","6","21011","21","011",11085,11009,76,47,29
"Bell County","Bell County, Kentucky","934384652","1510593    ","050","00","3","6","21013","21","013",30060,29863,197,70,127
"Boone County","Boone County, Kentucky","637811194","27718806   ","050","00","3","6","21015","21","015",85991,83407,2584,780,1804
"Bourbon County","Bourbon County, Kentucky","754799210","596672     ","050","00","3","6","21017","21","017",19360,18976,384,56,328
"Boyd County","Boyd County, Kentucky","414834483","4268713    ","050","00","3","6","21019","21","019",49752,49180,572,140,432
"Boyle County","Boyle County, Kentucky","471111135","2826418    ","050","00","3","6","21021","21","021",27697,27189,508,145,363
"Bracken County","Bracken County, Kentucky","526333281","14696299   ","050","00","3","6","21023","21","023",8279,8258,21,13,8
"Breathitt County","Breathitt County, Kentucky","1282544109","244193     ","050","00","3","6","21025","21","025",16100,16035,65,6,59
"Breckinridge County","Breckinridge County, Kentucky","1482535646","33975937   ","050","00","3","6","21027","21","027",18648,18548,100,66,34
"Bullitt County","Bullitt County, Kentucky","774604448","2908200    ","050","00","3","6","21029","21","029",61236,60863,373,246,127
"Butler County","Butler County, Kentucky","1108720714","8916548    ","050","00","3","6","21031","21","031",13010,12780,230,70,160
"Caldwell County","Caldwell County, Kentucky","898673451","3099508    ","050","00","3","6","21033","21","033",13060,13001,59,42,17
"Calloway County","Calloway County, Kentucky","1000392922","63536535   ","050","00","3","6","21035","21","035",34177,33259,918,199,719
"Campbell County","Campbell County, Kentucky","392523925","20395077   ","050","00","3","6","21037","21","037",88616,87393,1223,507,716
"Carlisle County","Carlisle County, Kentucky","498536885","16931931   ","050","00","3","6","21039","21","039",5351,5342,9,0,9
"Carroll County","Carroll County, Kentucky","336927272","18596070   ","050","00","3","6","21041","21","041",10155,9967,188,57,131
"Carter County","Carter County, Kentucky","1063446887","4005430    ","050","00","3","6","21043","21","043",26889,26789,100,62,38
"Casey County","Casey County, Kentucky","1154128617","301383     ","050","00","3","6","21045","21","045",15447,15257,190,33,157
"Christian County","Christian County, Kentucky","1868197282","6973595    ","050","00","3","6","21047","21","047",72265,70475,1790,856,934
"Clark County","Clark County, Kentucky","658660569","2188861    ","050","00","3","6","21049","21","049",33144,32824,320,125,195
"Clay County","Clay County, Kentucky","1219909733","179538     ","050","00","3","6","21051","21","051",24556,24392,164,44,120
"Clinton County","Clinton County, Kentucky","511406731","20941244   ","050","00","3","6","21053","21","053",9634,9553,81,26,55
"Crittenden County","Crittenden County, Kentucky","937940022","22817384   ","050","00","3","6","21055","21","055",9384,9343,41,17,24
"Cumberland County","Cumberland County, Kentucky","792076599","13013762   ","050","00","3","6","21057","21","057",7147,7128,19,9,10
"Daviess County","Daviess County, Kentucky","1197581574","35960165   ","050","00","3","6","21059","21","059",91545,90630,915,402,513
"Edmonson County","Edmonson County, Kentucky","783789990","13964294   ","050","00","3","6","21061","21","061",11644,11596,48,13,35
"Elliott County","Elliott County, Kentucky","605957318","3214977    ","050","00","3","6","21063","21","063",6748,6736,12,12,0
"Estill County","Estill County, Kentucky","657681296","4566122    ","050","00","3","6","21065","21","065",15307,15267,40,22,18
"Fayette County","Fayette County, Kentucky","736891307","2600547    ","050","00","3","6","21067","21","067",260512,245064,15448,3913,11535
"Fleming County","Fleming County, Kentucky","908680657","1618004    ","050","00","3","6","21069","21","069",13792,13767,25,19,6
"Floyd County","Floyd County, Kentucky","1021217616","3015317    ","050","00","3","6","21071","21","071",42441,42206,235,99,136
"Franklin County","Franklin County, Kentucky","545088647","4266321    ","050","00","3","6","21073","21","073",47687,46771,916,298,618
"Fulton County","Fulton County, Kentucky","541177806","55940607   ","050","00","3","6","21075","21","075",7752,7724,28,28,0
"Gallatin County","Gallatin County, Kentucky","255907333","15196831   ","050","00","3","6","21077","21","077",7870,7842,28,19,9
"Garrard County","Garrard County, Kentucky","598824325","6912004    ","050","00","3","6","21079","21","079",14792,14555,237,65,172
"Grant County","Grant County, Kentucky","673215866","2229839    ","050","00","3","6","21081","21","081",22384,22168,216,75,141
"Graves County","Graves County, Kentucky","1438975813","2251865    ","050","00","3","6","21083","21","083",37028,36242,786,177,609
"Grayson County","Grayson County, Kentucky","1304513526","18580493   ","050","00","3","6","21085","21","085",24053,23913,140,86,54
"Green County","Green County, Kentucky","747629079","300184     ","050","00","3","6","21087","21","087",11518,11433,85,37,48
"Greenup County","Greenup County, Kentucky","896409719","21774425   ","050","00","3","6","21089","21","089",36891,36673,218,169,49
"Hancock County","Hancock County, Kentucky","488990833","26217159   ","050","00","3","6","21091","21","091",8392,8322,70,37,33
"Hardin County","Hardin County, Kentucky","1626453011","4877254    ","050","00","3","6","21093","21","093",94174,89907,4267,2405,1862
"Harlan County","Harlan County, Kentucky","1210029535","2011449    ","050","00","3","6","21095","21","095",33202,32996,206,91,115
"Harrison County","Harrison County, Kentucky","802065260","510094     ","050","00","3","6","21097","21","097",17983,17770,213,130,83
"Hart County","Hart County, Kentucky","1077254187","5133869    ","050","00","3","6","21099","21","099",17445,17346,99,31,68
"Henderson County","Henderson County, Kentucky","1139916860","70219199   ","050","00","3","6","21101","21","101",44829,44354,475,213,262
"Henry County","Henry County, Kentucky","749329544","4643060    ","050","00","3","6","21103","21","103",15060,14851,209,64,145
"Hickman County","Hickman County, Kentucky","633109390","21997560   ","050","00","3","6","21105","21","105",5262,5232,30,28,2
"Hopkins County","Hopkins County, Kentucky","1425939026","9517988    ","050","00","3","6","21107","21","107",46519,46254,265,137,128
"Jackson County","Jackson County, Kentucky","896993001","625470     ","050","00","3","6","21109","21","109",13495,13439,56,37,19
"Jefferson County","Jefferson County, Kentucky","997372560","34933418   ","050","00","3","6","21111","21","111",693604,669709,23895,8317,15578
"Jessamine County","Jessamine County, Kentucky","448412225","3418347    ","050","00","3","6","21113","21","113",39041,38357,684,198,486
"Johnson County","Johnson County, Kentucky","677395112","6213074    ","050","00","3","6","21115","21","115",23445,23331,114,54,60
"Kenton County","Kenton County, Kentucky","419490114","6256655    ","050","00","3","6","21117","21","117",151464,149082,2382,1122,1260
"Knott County","Knott County, Kentucky","912174899","2122837    ","050","00","3","6","21119","21","119",17649,17581,68,41,27
"Knox County","Knox County, Kentucky","1004046439","108036     ","050","00","3","6","21121","21","121",31795,31667,128,72,56
"Larue County","Larue County, Kentucky","681675308","1362450    ","050","00","3","6","21123","21","123",13373,13313,60,23,37
"Laurel County","Laurel County, Kentucky","1128378888","20904577   ","050","00","3","6","21125","21","125",52715,52313,402,142,260
"Lawrence County","Lawrence County, Kentucky","1084622342","3495580    ","050","00","3","6","21127","21","127",15569,15546,23,9,14
"Lee County","Lee County, Kentucky","543533117","3514818    ","050","00","3","6","21129","21","129",7916,7900,16,0,16
"Leslie County","Leslie County, Kentucky","1046433067","857464     ","050","00","3","6","21131","21","131",12401,12382,19,9,10
"Letcher County","Letcher County, Kentucky","878120322","191554     ","050","00","3","6","21133","21","133",25277,25185,92,52,40
"Lewis County","Lewis County, Kentucky","1254818557","29037349   ","050","00","3","6","21135","21","135",14092,14071,21,6,15
"Lincoln County","Lincoln County, Kentucky","870905604","551368     ","050","00","3","6","21137","21","137",23361,23203,158,34,124
"Livingston County","Livingston County, Kentucky","818648229","67644646   ","050","00","3","6","21139","21","139",9804,9788,16,8,8
"Logan County","Logan County, Kentucky","1439216087","3659735    ","050","00","3","6","21141","21","141",26573,26354,219,67,152
"Lyon County","Lyon County, Kentucky","558667225","105450646  ","050","00","3","6","21143","21","143",8080,8012,68,5,63
"McCracken County","McCracken County, Kentucky","650151003","44170785   ","050","00","3","6","21145","21","145",65514,64908,606,268,338
"McCreary County","McCreary County, Kentucky","1107732620","7610693    ","050","00","3","6","21147","21","147",17080,16989,91,36,55
"McLean County","McLean County, Kentucky","658621474","4865347    ","050","00","3","6","21149","21","149",9938,9869,69,16,53
"Madison County","Madison County, Kentucky","1141362670","6279386    ","050","00","3","6","21151","21","151",70872,69808,1064,367,697
"Magoffin County","Magoffin County, Kentucky","801437172","15852      ","050","00","3","6","21153","21","153",13332,13308,24,19,5
"Marion County","Marion County, Kentucky","897154272","1212431    ","050","00","3","6","21155","21","155",18212,17987,225,113,112
"Marshall County","Marshall County, Kentucky","789648719","91774088   ","050","00","3","6","21157","21","157",30125,29869,256,122,134
"Martin County","Martin County, Kentucky","597509461","285233     ","050","00","3","6","21159","21","159",12578,12569,9,9,0
"Mason County","Mason County, Kentucky","624469278","14224648   ","050","00","3","6","21161","21","161",16800,16568,232,43,189
"Meade County","Meade County, Kentucky","799024556","40698446   ","050","00","3","6","21163","21","163",26349,25831,518,281,237
"Menifee County","Menifee County, Kentucky","528093728","5519523    ","050","00","3","6","21165","21","165",6556,6533,23,9,14
"Mercer County","Mercer County, Kentucky","649869025","5689445    ","050","00","3","6","21167","21","167",20817,20454,363,90,273
"Metcalfe County","Metcalfe County, Kentucky","753414695","178981     ","050","00","3","6","21169","21","169",10037,10019,18,7,11
"Monroe County","Monroe County, Kentucky","856789301","3359278    ","050","00","3","6","21171","21","171",11756,11593,163,66,97
"Montgomery County","Montgomery County, Kentucky","514349457","549567     ","050","00","3","6","21173","21","173",22554,22448,106,29,77
"Morgan County","Morgan County, Kentucky","987464950","6388343    ","050","00","3","6","21175","21","175",13948,13857,91,17,74
"Muhlenberg County","Muhlenberg County, Kentucky","1229515420","12211520   ","050","00","3","6","21177","21","177",31839,31728,111,46,65
"Nelson County","Nelson County, Kentucky","1094597666","3746524    ","050","00","3","6","21179","21","179",37477,37025,452,165,287
"Nicholas County","Nicholas County, Kentucky","509214246","619074     ","050","00","3","6","21181","21","181",6813,6782,31,13,18
"Ohio County","Ohio County, Kentucky","1537906727","7622677    ","050","00","3","6","21183","21","183",22916,22760,156,37,119
"Oldham County","Oldham County, Kentucky","489994293","19050478   ","050","00","3","6","21185","21","185",46178,45438,740,329,411
"Owen County","Owen County, Kentucky","912039375","5224152    ","050","00","3","6","21187","21","187",10547,10477,70,21,49
"Owsley County","Owsley County, Kentucky","513052778","0          ","050","00","3","6","21189","21","189",4858,4853,5,0,5
"Pendleton County","Pendleton County, Kentucky","726582981","3455601    ","050","00","3","6","21191","21","191",14390,14311,79,15,64
"Perry County","Perry County, Kentucky","886165449","1261922    ","050","00","3","6","21193","21","193",29390,29212,178,71,107
"Pike County","Pike County, Kentucky","2040104346","2991134    ","050","00","3","6","21195","21","195",68736,68452,284,108,176
"Powell County","Powell County, Kentucky","466547963","178187     ","050","00","3","6","21197","21","197",13237,13204,33,22,11
"Pulaski County","Pulaski County, Kentucky","1713547231","40012104   ","050","00","3","6","21199","21","199",56217,55790,427,179,248
"Robertson County","Robertson County, Kentucky","259178528","95294      ","050","00","3","6","21201","21","201",2266,2255,11,8,3
"Rockcastle County","Rockcastle County, Kentucky","822388337","1392238    ","050","00","3","6","21203","21","203",16582,16578,4,0,4
"Rowan County","Rowan County, Kentucky","727326139","14060336   ","050","00","3","6","21205","21","205",22094,21776,318,73,245
"Russell County","Russell County, Kentucky","656643458","75866648   ","050","00","3","6","21207","21","207",16315,16152,163,81,82
"Scott County","Scott County, Kentucky","737425704","1487159    ","050","00","3","6","21209","21","209",33061,32430,631,163,468
"Shelby County","Shelby County, Kentucky","995047404","3768612    ","050","00","3","6","21211","21","211",33337,32053,1284,223,1061
"Simpson County","Simpson County, Kentucky","611725481","11146      ","050","00","3","6","21213","21","213",16405,16210,195,104,91
"Spencer County","Spencer County, Kentucky","481485022","15263226   ","050","00","3","6","21215","21","215",11766,11626,140,96,44
"Taylor County","Taylor County, Kentucky","698854538","18694337   ","050","00","3","6","21217","21","217",22927,22630,297,83,214
"Todd County","Todd County, Kentucky","974748494","1604413    ","050","00","3","6","21219","21","219",11971,11814,157,56,101
"Trigg County","Trigg County, Kentucky","1147675094","98444179   ","050","00","3","6","21221","21","221",12597,12492,105,36,69
"Trimble County","Trimble County, Kentucky","385515861","19123658   ","050","00","3","6","21223","21","223",8125,8032,93,33,60
"Union County","Union County, Kentucky","893798807","47474852   ","050","00","3","6","21225","21","225",15637,15425,212,99,113
"Warren County","Warren County, Kentucky","1412090437","6420798    ","050","00","3","6","21227","21","227",92522,88567,3955,874,3081
"Washington County","Washington County, Kentucky","778532633","2399145    ","050","00","3","6","21229","21","229",10916,10840,76,17,59
"Wayne County","Wayne County, Kentucky","1189834019","64239264   ","050","00","3","6","21231","21","231",19923,19664,259,62,197
"Webster County","Webster County, Kentucky","867003971","2407857    ","050","00","3","6","21233","21","233",14120,13848,272,55,217
"Whitley County","Whitley County, Kentucky","1139993122","12929454   ","050","00","3","6","21235","21","235",35865,35609,256,103,153
"Wolfe County","Wolfe County, Kentucky","577005558","207261     ","050","00","3","6","21237","21","237",7065,7016,49,0,49
"Woodford County","Woodford County, Kentucky","493854910","3376650    ","050","00","3","6","21239","21","239",23208,22591,617,150,467
"Acadia Parish","Acadia Parish, Louisiana","1697175452","6040142    ","050","00","3","7","22001","22","001",58861,58603,258,130,128
"Allen Parish","Allen Parish, Louisiana","1980039777","3041806    ","050","00","3","7","22003","22","003",25440,25292,148,78,70
"Ascension Parish","Ascension Parish, Louisiana","755057544","29404973   ","050","00","3","7","22005","22","005",76627,75224,1403,477,926
"Assumption Parish","Assumption Parish, Louisiana","877182021","67006609   ","050","00","3","7","22007","22","007",23388,23197,191,120,71
"Avoyelles Parish","Avoyelles Parish, Louisiana","2156001847","86085516   ","050","00","3","7","22009","22","009",41481,41258,223,152,71
"Beauregard Parish","Beauregard Parish, Louisiana","3004623471","15271132   ","050","00","3","7","22011","22","011",32986,32621,365,187,178
"Bienville Parish","Bienville Parish, Louisiana","2099544763","28820898   ","050","00","3","7","22013","22","013",15752,15688,64,26,38
"Bossier Parish","Bossier Parish, Louisiana","2173650441","71697486   ","050","00","3","7","22015","22","015",98310,95867,2443,1182,1261
"Caddo Parish","Caddo Parish, Louisiana","2284352103","142214037  ","050","00","3","7","22017","22","017",252161,248380,3781,1894,1887
"Calcasieu Parish","Calcasieu Parish, Louisiana","2774180172","60137061   ","050","00","3","7","22019","22","019",183577,181057,2520,1081,1439
"Caldwell Parish","Caldwell Parish, Louisiana","1371183168","29269782   ","050","00","3","7","22021","22","021",10560,10492,68,35,33
"Cameron Parish","Cameron Parish, Louisiana","3400563105","1602251023 ","050","00","3","7","22023","22","023",9991,9835,156,34,122
"Catahoula Parish","Catahoula Parish, Louisiana","1822441810","92681855   ","050","00","3","7","22025","22","025",10920,10911,9,6,3
"Claiborne Parish","Claiborne Parish, Louisiana","1954543267","33402036   ","050","00","3","7","22027","22","027",16851,16791,60,32,28
"Concordia Parish","Concordia Parish, Louisiana","1802398443","136677792  ","050","00","3","7","22029","22","029",20247,19988,259,71,188
"De Soto Parish","De Soto Parish, Louisiana","2271936425","44770496   ","050","00","3","7","22031","22","031",25494,25247,247,61,186
"East Baton Rouge Parish","East Baton Rouge Parish, Louisiana","1179553107","39139418   ","050","00","3","7","22033","22","033",412852,397378,15474,6273,9201
"East Carroll Parish","East Carroll Parish, Louisiana","1091524613","54418281   ","050","00","3","7","22035","22","035",9421,9338,83,66,17
"East Feliciana Parish","East Feliciana Parish, Louisiana","1174305372","5930903    ","050","00","3","7","22037","22","037",21360,21239,121,57,64
"Evangeline Parish","Evangeline Parish, Louisiana","1720456451","39719250   ","050","00","3","7","22039","22","039",35434,35210,224,96,128
"Franklin Parish","Franklin Parish, Louisiana","1615147241","30606415   ","050","00","3","7","22041","22","041",21263,21136,127,69,58
"Grant Parish","Grant Parish, Louisiana","1670838229","50372917   ","050","00","3","7","22043","22","043",18698,18598,100,59,41
"Iberia Parish","Iberia Parish, Louisiana","1489579125","1180327352 ","050","00","3","7","22045","22","045",73266,71782,1484,644,840
"Iberville Parish","Iberville Parish, Louisiana","1602274118","88569943   ","050","00","3","7","22047","22","047",33320,33092,228,129,99
"Jackson Parish","Jackson Parish, Louisiana","1475653466","27430078   ","050","00","3","7","22049","22","049",15397,15328,69,44,25
"Jefferson Parish","Jefferson Parish, Louisiana","793875552","869955879  ","050","00","3","7","22051","22","051",455466,421404,34062,17850,16212
"Jefferson Davis Parish","Jefferson Davis Parish, Louisiana","1689476509","16226098   ","050","00","3","7","22053","22","053",31435,31254,181,90,91
"Lafayette Parish","Lafayette Parish, Louisiana","698868121","1179034    ","050","00","3","7","22055","22","055",190503,185740,4763,1823,2940
"Lafourche Parish","Lafourche Parish, Louisiana","2809306755","1003642145 ","050","00","3","7","22057","22","057",89974,88638,1336,614,722
"La Salle Parish","La Salle Parish, Louisiana","1615703132","99806462   ","050","00","3","7","22059","22","059",14282,14191,91,29,62
"Lincoln Parish","Lincoln Parish, Louisiana","1220861752","2310360    ","050","00","3","7","22061","22","061",42509,41609,900,299,601
"Livingston Parish","Livingston Parish, Louisiana","1678368583","141984918  ","050","00","3","7","22063","22","063",91814,91112,702,352,350
"Madison Parish","Madison Parish, Louisiana","1616375624","68497176   ","050","00","3","7","22065","22","065",13728,13665,63,25,38
"Morehouse Parish","Morehouse Parish, Louisiana","2057092298","28358719   ","050","00","3","7","22067","22","067",31021,30911,110,88,22
"Natchitoches Parish","Natchitoches Parish, Louisiana","3251593004","113572696  ","050","00","3","7","22069","22","069",39080,38510,570,249,321
"Orleans Parish","Orleans Parish, Louisiana","467638563","439413285  ","050","00","3","7","22071","22","071",484674,464093,20581,10227,10354
"Ouachita Parish","Ouachita Parish, Louisiana","1581261555","57424910   ","050","00","3","7","22073","22","073",147250,145763,1487,816,671
"Plaquemines Parish","Plaquemines Parish, Louisiana","2187399020","4102483351 ","050","00","3","7","22075","22","075",26757,26014,743,345,398
"Pointe Coupee Parish","Pointe Coupee Parish, Louisiana","1443510751","86355683   ","050","00","3","7","22077","22","077",22763,22565,198,92,106
"Rapides Parish","Rapides Parish, Louisiana","3425365854","102099480  ","050","00","3","7","22079","22","079",126337,124368,1969,801,1168
"Red River Parish","Red River Parish, Louisiana","1008251074","33122817   ","050","00","3","7","22081","22","081",9622,9579,43,27,16
"Richland Parish","Richland Parish, Louisiana","1446390668","15672330   ","050","00","3","7","22083","22","083",20981,20874,107,63,44
"Sabine Parish","Sabine Parish, Louisiana","2241026064","378774247  ","050","00","3","7","22085","22","085",23459,23232,227,89,138
"St. Bernard Parish","St. Bernard Parish, Louisiana","1204448111","3441345659 ","050","00","3","7","22087","22","087",67229,65210,2019,1260,759
"St. Charles Parish","St. Charles Parish, Louisiana","734626736","327679665  ","050","00","3","7","22089","22","089",48072,46880,1192,608,584
"St. Helena Parish","St. Helena Parish, Louisiana","1057652179","2833347    ","050","00","3","7","22091","22","091",10525,10498,27,12,15
"St. James Parish","St. James Parish, Louisiana","637479684","30203631   ","050","00","3","7","22093","22","093",21216,21172,44,22,22
"St. John the Baptist Parish","St. John the Baptist Parish, Louisiana","566936163","333956046  ","050","00","3","7","22095","22","095",43044,42044,1000,554,446
"St. Landry Parish","St. Landry Parish, Louisiana","2405193012","26363948   ","050","00","3","7","22097","22","097",87700,87245,455,202,253
"St. Martin Parish","St. Martin Parish, Louisiana","1916209299","198400419  ","050","00","3","7","22099","22","099",48583,48131,452,161,291
"St. Mary Parish","St. Mary Parish, Louisiana","1587131422","1310632371 ","050","00","3","7","22101","22","101",53500,52423,1077,407,670
"St. Tammany Parish","St. Tammany Parish, Louisiana","2212242631","699120181  ","050","00","3","7","22103","22","103",191268,186740,4528,2735,1793
"Tangipahoa Parish","Tangipahoa Parish, Louisiana","2046724722","85149577   ","050","00","3","7","22105","22","105",100588,99738,850,358,492
"Tensas Parish","Tensas Parish, Louisiana","1560423577","100278846  ","050","00","3","7","22107","22","107",6618,6539,79,6,73
"Terrebonne Parish","Terrebonne Parish, Louisiana","3250254613","2136656398 ","050","00","3","7","22109","22","109",104503,102974,1529,710,819
"Union Parish","Union Parish, Louisiana","2272977992","71682295   ","050","00","3","7","22111","22","111",22803,22522,281,87,194
"Vermilion Parish","Vermilion Parish, Louisiana","3040079728","944135007  ","050","00","3","7","22113","22","113",53807,52726,1081,423,658
"Vernon Parish","Vernon Parish, Louisiana","3440574407","33915990   ","050","00","3","7","22115","22","115",52531,50362,2169,1168,1001
"Washington Parish","Washington Parish, Louisiana","1734176045","16586049   ","050","00","3","7","22117","22","117",43926,43740,186,128,58
"Webster Parish","Webster Parish, Louisiana","1541620472","51407609   ","050","00","3","7","22119","22","119",41831,41557,274,175,99
"West Baton Rouge Parish","West Baton Rouge Parish, Louisiana","495213465","32171115   ","050","00","3","7","22121","22","121",21601,21409,192,87,105
"West Carroll Parish","West Carroll Parish, Louisiana","930837516","2387401    ","050","00","3","7","22123","22","123",12314,12276,38,27,11
"West Feliciana Parish","West Feliciana Parish, Louisiana","1051547354","51818395   ","050","00","3","7","22125","22","125",15111,15029,82,51,31
"Winn Parish","Winn Parish, Louisiana","2461746162","16651512   ","050","00","3","7","22127","22","127",16894,16802,92,39,53
"Androscoggin County","Androscoggin County, Maine","1218003476","69807833   ","050","00","1","1","23001","23","001",103793,101135,2658,1601,1057
"Aroostook County","Aroostook County, Maine","17279217313","407264668  ","050","00","1","1","23003","23","003",73938,69634,4304,2558,1746
"Cumberland County","Cumberland County, Maine","2163958964","987766036  ","050","00","1","1","23005","23","005",265612,255496,10116,4923,5193
"Franklin County","Franklin County, Maine","4397303667","120428616  ","050","00","1","1","23007","23","007",29467,28981,486,292,194
"Hancock County","Hancock County, Maine","4112117764","1977009068 ","050","00","1","1","23009","23","009",51791,50613,1178,598,580
"Kennebec County","Kennebec County, Maine","2247026695","216522570  ","050","00","1","1","23011","23","011",117114,114524,2590,1577,1013
"Knox County","Knox County, Maine","947084855","2010938003 ","050","00","1","1","23013","23","013",39618,38805,813,377,436
"Lincoln County","Lincoln County, Maine","1181021394","631490154  ","050","00","1","1","23015","23","015",33616,32938,678,468,210
"Oxford County","Oxford County, Maine","5382004142","251905665  ","050","00","1","1","23017","23","017",54755,53762,993,631,362
"Penobscot County","Penobscot County, Maine","8794889730","415467871  ","050","00","1","1","23019","23","019",144919,141273,3646,1869,1777
"Piscataquis County","Piscataquis County, Maine","10272468390","1064838515 ","050","00","1","1","23021","23","021",17235,16909,326,172,154
"Sagadahoc County","Sagadahoc County, Maine","657595447","301193531  ","050","00","1","1","23023","23","023",35214,34374,840,507,333
"Somerset County","Somerset County, Maine","10169586648","437381151  ","050","00","1","1","23025","23","025",50888,50009,879,525,354
"Waldo County","Waldo County, Maine","1889988750","318603172  ","050","00","1","1","23027","23","027",36280,35661,619,332,287
"Washington County","Washington County, Maine","6652325061","1777862890 ","050","00","1","1","23029","23","029",33941,32555,1386,732,654
"York County","York County, Maine","2566460305","726297502  ","050","00","1","1","23031","23","031",186742,181563,5179,3090,2089
"Allegany County","Allegany County, Maryland","1101831391","11392507   ","050","00","3","5","24001","24","001",74930,74006,924,464,460
"Anne Arundel County","Anne Arundel County, Maryland","1077274201","445367086  ","050","00","3","5","24003","24","003",489656,466445,23211,12441,10770
"Baltimore County","Baltimore County, Maryland","1550332696","216110304  ","050","00","3","5","24005","24","005",754292,700508,53784,28791,24993
"Calvert County","Calvert County, Maryland","557298766","336473141  ","050","00","3","5","24009","24","009",74563,72920,1643,902,741
"Caroline County","Caroline County, Maryland","829160736","15325163   ","050","00","3","5","24011","24","011",29772,29016,756,213,543
"Carroll County","Carroll County, Maryland","1163229343","8472686    ","050","00","3","5","24013","24","013",150897,147851,3046,1826,1220
"Cecil County","Cecil County, Maryland","901663925","180641585  ","050","00","3","5","24015","24","015",85951,84384,1567,849,718
"Charles County","Charles County, Maryland","1193987549","471936852  ","050","00","3","5","24017","24","017",120546,117076,3470,2021,1449
"Dorchester County","Dorchester County, Maryland","1444022503","1101717742 ","050","00","3","5","24019","24","019",30674,30070,604,276,328
"Frederick County","Frederick County, Maryland","1716838523","11552052   ","050","00","3","5","24021","24","021",195277,187498,7779,3886,3893
"Garrett County","Garrett County, Maryland","1678197020","20573957   ","050","00","3","5","24023","24","023",29846,29595,251,158,93
"Harford County","Harford County, Maryland","1140499738","223692372  ","050","00","3","5","24025","24","025",218590,211226,7364,4787,2577
"Howard County","Howard County, Maryland","652778235","3904123    ","050","00","3","5","24027","24","027",247842,219729,28113,14714,13399
"Kent County","Kent County, Maryland","723731882","349318578  ","050","00","3","5","24029","24","029",19197,18635,562,241,321
"Montgomery County","Montgomery County, Maryland","1283380074","30115059   ","050","00","3","5","24031","24","031",873341,640345,232996,100658,132338
"Prince George's County","Prince George's County, Maryland","1257264173","33705194   ","050","00","3","5","24033","24","033",801515,691034,110481,42817,67664
"Queen Anne's County","Queen Anne's County, Maryland","964006714","356333184  ","050","00","3","5","24035","24","035",40563,39591,972,515,457
"St. Mary's County","St. Mary's County, Maryland","935634810","1044418779 ","050","00","3","5","24037","24","037",86211,83779,2432,1420,1012
"Somerset County","Somerset County, Maryland","847481698","734421890  ","050","00","3","5","24039","24","039",24747,24127,620,221,399
"Talbot County","Talbot County, Maryland","697064276","537777133  ","050","00","3","5","24041","24","041",33812,32703,1109,568,541
"Washington County","Washington County, Maryland","1186567624","24369551   ","050","00","3","5","24043","24","043",131923,129446,2477,1360,1117
"Wicomico County","Wicomico County, Maryland","976869361","58588694   ","050","00","3","5","24045","24","045",84644,81380,3264,1467,1797
"Worcester County","Worcester County, Maryland","1225679185","573667249  ","050","00","3","5","24047","24","047",46543,45291,1252,595,657
"Baltimore city","Baltimore city, Maryland","209282442","29198774   ","050","00","3","5","24510","24","510",651154,621516,29638,13521,16117
"Barnstable County","Barnstable County, Massachusetts","1024377791","2357157238 ","050","00","1","1","25001","25","001",222230,211248,10982,5784,5198
"Berkshire County","Berkshire County, Massachusetts","2412100627","38727640   ","050","00","1","1","25003","25","003",134953,130007,4946,2740,2206
"Bristol County","Bristol County, Massachusetts","1440023877","350150973  ","050","00","1","1","25005","25","005",534678,471865,62813,36225,26588
"Dukes County","Dukes County, Massachusetts","268785990","1002778678 ","050","00","1","1","25007","25","007",14987,14042,945,318,627
"Essex County","Essex County, Massachusetts","1296721801","849153015  ","050","00","1","1","25009","25","009",723419,641380,82039,33707,48332
"Franklin County","Franklin County, Massachusetts","1818244807","58820215   ","050","00","1","1","25011","25","011",71535,68925,2610,1162,1448
"Hampden County","Hampden County, Massachusetts","1601658602","40694918   ","050","00","1","1","25013","25","013",456228,423195,33033,16458,16575
"Hampshire County","Hampshire County, Massachusetts","1370179607","42491330   ","050","00","1","1","25015","25","015",152251,142278,9973,4380,5593
"Middlesex County","Middlesex County, Massachusetts","2132746255","62377480   ","050","00","1","1","25017","25","017",1465396,1241931,223465,91978,131487
"Nantucket County","Nantucket County, Massachusetts","123826853","662591799  ","050","00","1","1","25019","25","019",9520,8761,759,192,567
"Norfolk County","Norfolk County, Massachusetts","1034915597","114878501  ","050","00","1","1","25021","25","021",650308,573576,76732,42260,34472
"Plymouth County","Plymouth County, Massachusetts","1711596642","1120262554 ","050","00","1","1","25023","25","023",472822,443230,29592,13636,15956
"Suffolk County","Suffolk County, Massachusetts","151555693","159745094  ","050","00","1","1","25025","25","025",689807,513776,176031,63450,112581
"Worcester County","Worcester County, Massachusetts","3918817426","170822271  ","050","00","1","1","25027","25","027",750963,691900,59063,25327,33736
"Alcona County","Alcona County, Michigan","1746776250","2890690938 ","050","00","2","3","26001","26","001",11719,11543,176,121,55
"Alger County","Alger County, Michigan","2377170025","10699883373","050","00","2","3","26003","26","003",9862,9763,99,53,46
"Allegan County","Allegan County, Michigan","2143123718","2605100219 ","050","00","2","3","26005","26","005",105665,102579,3086,1269,1817
"Alpena County","Alpena County, Michigan","1487042096","2902986576 ","050","00","2","3","26007","26","007",31314,30953,361,167,194
"Antrim County","Antrim County, Michigan","1235262187","323663078  ","050","00","2","3","26009","26","009",23110,22761,349,209,140
"Arenac County","Arenac County, Michigan","950117635","813177035  ","050","00","2","3","26011","26","011",17269,17083,186,128,58
"Baraga County","Baraga County, Michigan","2341341138","426959496  ","050","00","2","3","26013","26","013",8746,8680,66,39,27
"Barry County","Barry County, Michigan","1440383061","53786902   ","050","00","2","3","26015","26","015",56755,56292,463,304,159
"Bay County","Bay County, Michigan","1150591713","483447041  ","050","00","2","3","26017","26","017",110157,108621,1536,859,677
"Benzie County","Benzie County, Michigan","832197831","1394250656 ","050","00","2","3","26019","26","019",15998,15729,269,170,99
"Berrien County","Berrien County, Michigan","1478882557","2616885082 ","050","00","2","3","26021","26","021",162453,154562,7891,3029,4862
"Branch County","Branch County, Michigan","1314191146","31282225   ","050","00","2","3","26023","26","023",45787,44607,1180,358,822
"Calhoun County","Calhoun County, Michigan","1835566474","25186093   ","050","00","2","3","26025","26","025",137985,134727,3258,1320,1938
"Cass County","Cass County, Michigan","1274736966","42180313   ","050","00","2","3","26027","26","027",51104,50125,979,470,509
"Charlevoix County","Charlevoix County, Michigan","1079610710","2522451715 ","050","00","2","3","26029","26","029",26090,25730,360,200,160
"Cheboygan County","Cheboygan County, Michigan","1853391663","439339858  ","050","00","2","3","26031","26","031",26448,26118,330,250,80
"Chippewa County","Chippewa County, Michigan","4043131735","2944608013 ","050","00","2","3","26033","26","033",38543,37381,1162,605,557
"Clare County","Clare County, Michigan","1467993832","21812624   ","050","00","2","3","26035","26","035",31252,30916,336,212,124
"Clinton County","Clinton County, Michigan","1480069137","8070398    ","050","00","2","3","26037","26","037",64753,63970,783,418,365
"Crawford County","Crawford County, Michigan","1445530829","13601164   ","050","00","2","3","26039","26","039",14273,14090,183,121,62
"Delta County","Delta County, Michigan","3030351121","2127826538 ","050","00","2","3","26041","26","041",38520,38142,378,227,151
"Dickinson County","Dickinson County, Michigan","1984803209","27918825   ","050","00","2","3","26043","26","043",27472,27177,295,213,82
"Eaton County","Eaton County, Michigan","1492894246","6765482    ","050","00","2","3","26045","26","045",103655,101389,2266,1110,1156
"Emmet County","Emmet County, Michigan","1211649163","1073402953 ","050","00","2","3","26047","26","047",31437,30896,541,245,296
"Genesee County","Genesee County, Michigan","1656660341","25129673   ","050","00","2","3","26049","26","049",436141,426788,9353,5867,3486
"Gladwin County","Gladwin County, Michigan","1312614778","24937206   ","050","00","2","3","26051","26","051",26023,25693,330,260,70
"Gogebic County","Gogebic County, Michigan","2853804694","970143393  ","050","00","2","3","26053","26","053",17370,17151,219,182,37
"Grand Traverse County","Grand Traverse County, Michigan","1204527945","352403674  ","050","00","2","3","26055","26","055",77654,75988,1666,881,785
"Gratiot County","Gratiot County, Michigan","1476625630","3834251    ","050","00","2","3","26057","26","057",42285,41766,519,243,276
"Hillsdale County","Hillsdale County, Michigan","1550995291","21491712   ","050","00","2","3","26059","26","059",46527,45992,535,258,277
"Houghton County","Houghton County, Michigan","2620341964","1268676121 ","050","00","2","3","26061","26","061",36016,35039,977,359,618
"Huron County","Huron County, Michigan","2166569275","3366858506 ","050","00","2","3","26063","26","063",36079,35571,508,251,257
"Ingham County","Ingham County, Michigan","1448291334","4534393    ","050","00","2","3","26065","26","065",279320,261857,17463,5577,11886
"Ionia County","Ionia County, Michigan","1484616954","18175940   ","050","00","2","3","26067","26","067",61518,60802,716,241,475
"Iosco County","Iosco County, Michigan","1422193938","3474873606 ","050","00","2","3","26069","26","069",27339,26995,344,234,110
"Iron County","Iron County, Michigan","3020846180","115682109  ","050","00","2","3","26071","26","071",13138,12987,151,119,32
"Isabella County","Isabella County, Michigan","1487359266","9006922    ","050","00","2","3","26073","26","073",63351,61884,1467,487,980
"Jackson County","Jackson County, Michigan","1830079005","44462965   ","050","00","2","3","26075","26","075",158422,155785,2637,1334,1303
"Kalamazoo County","Kalamazoo County, Michigan","1455220328","47439593   ","050","00","2","3","26077","26","077",238603,229022,9581,3849,5732
"Kalkaska County","Kalkaska County, Michigan","1453024813","25241584   ","050","00","2","3","26079","26","079",16571,16433,138,82,56
"Kent County","Kent County, Michigan","2217482769","41453062   ","050","00","2","3","26081","26","081",574335,536181,38154,12040,26114
"Keweenaw County","Keweenaw County, Michigan","1401117836","14050638432","050","00","2","3","26083","26","083",2301,2277,24,18,6
"Lake County","Lake County, Michigan","1469650004","18566736   ","050","00","2","3","26085","26","085",11333,11220,113,67,46
"Lapeer County","Lapeer County, Michigan","1694380864","22996294   ","050","00","2","3","26087","26","087",87904,86007,1897,981,916
"Leelanau County","Leelanau County, Michigan","902529823","5656298953 ","050","00","2","3","26089","26","089",21119,20650,469,217,252
"Lenawee County","Lenawee County, Michigan","1943790358","28001355   ","050","00","2","3","26091","26","091",98890,97259,1631,788,843
"Livingston County","Livingston County, Michigan","1472143217","44118848   ","050","00","2","3","26093","26","093",156951,152236,4715,2397,2318
"Luce County","Luce County, Michigan","2338974196","2612787425 ","050","00","2","3","26095","26","095",7024,6949,75,41,34
"Mackinac County","Mackinac County, Michigan","2645886628","2794506294 ","050","00","2","3","26097","26","097",11943,11803,140,89,51
"Macomb County","Macomb County, Michigan","1244329825","231392703  ","050","00","2","3","26099","26","099",788149,719142,69007,36883,32124
"Manistee County","Manistee County, Michigan","1407937130","1909244646 ","050","00","2","3","26101","26","101",24527,24217,310,176,134
"Marquette County","Marquette County, Michigan","4716501275","4154659804 ","050","00","2","3","26103","26","103",64634,63697,937,544,393
"Mason County","Mason County, Michigan","1282477630","1933936905 ","050","00","2","3","26105","26","105",28274,27818,456,282,174
"Mecosta County","Mecosta County, Michigan","1439237247","39914298   ","050","00","2","3","26107","26","107",40553,39772,781,302,479
"Menominee County","Menominee County, Michigan","2702708106","762665242  ","050","00","2","3","26109","26","109",25326,25106,220,116,104
"Midland County","Midland County, Michigan","1349885621","17343934   ","050","00","2","3","26111","26","111",82874,80263,2611,918,1693
"Missaukee County","Missaukee County, Michigan","1467865737","18326862   ","050","00","2","3","26113","26","113",14478,14334,144,79,65
"Monroe County","Monroe County, Michigan","1427343313","333921043  ","050","00","2","3","26115","26","115",145945,143182,2763,1527,1236
"Montcalm County","Montcalm County, Michigan","1833815128","33524665   ","050","00","2","3","26117","26","117",61266,60575,691,351,340
"Montmorency County","Montmorency County, Michigan","1418346898","38369080   ","050","00","2","3","26119","26","119",10315,10177,138,98,40
"Muskegon County","Muskegon County, Michigan","1318605774","2460955731 ","050","00","2","3","26121","26","121",170200,167041,3159,1602,1557
"Newaygo County","Newaygo County, Michigan","2181722261","49275375   ","050","00","2","3","26123","26","123",47874,47022,852,310,542
"Oakland County","Oakland County, Michigan","2259793193","91913539   ","050","00","2","3","26125","26","125",1194156,1074938,119218,58944,60274
"Oceana County","Oceana County, Michigan","1399779193","1984623080 ","050","00","2","3","26127","26","127",26873,25704,1169,262,907
"Ogemaw County","Ogemaw County, Michigan","1461540211","26748977   ","050","00","2","3","26129","26","129",21645,21372,273,189,84
"Ontonagon County","Ontonagon County, Michigan","3396859446","6293454409 ","050","00","2","3","26131","26","131",7818,7707,111,48,63
"Osceola County","Osceola County, Michigan","1465886433","18447676   ","050","00","2","3","26133","26","133",23197,22922,275,180,95
"Oscoda County","Oscoda County, Michigan","1463348879","17014255   ","050","00","2","3","26135","26","135",9418,9276,142,91,51
"Otsego County","Otsego County, Michigan","1332658596","29629911   ","050","00","2","3","26137","26","137",23301,22934,367,219,148
"Ottawa County","Ottawa County, Michigan","1465036914","2761743542 ","050","00","2","3","26139","26","139",238314,226647,11667,5584,6083
"Presque Isle County","Presque Isle County, Michigan","1709580089","4953820111 ","050","00","2","3","26141","26","141",14411,14241,170,126,44
"Roscommon County","Roscommon County, Michigan","1350419147","151368050  ","050","00","2","3","26143","26","143",25469,25041,428,320,108
"Saginaw County","Saginaw County, Michigan","2095122995","17737467   ","050","00","2","3","26145","26","145",210039,205749,4290,2252,2038
"St. Clair County","St. Clair County, Michigan","1876113358","290751728  ","050","00","2","3","26147","26","147",164235,159782,4453,2548,1905
"St. Joseph County","St. Joseph County, Michigan","1304633739","45150438   ","050","00","2","3","26149","26","149",62422,60291,2131,682,1449
"Sanilac County","Sanilac County, Michigan","2496226301","1622422823 ","050","00","2","3","26151","26","151",44547,43839,708,413,295
"Schoolcraft County","Schoolcraft County, Michigan","3051289093","1827449141 ","050","00","2","3","26153","26","153",8903,8811,92,69,23
"Shiawassee County","Shiawassee County, Michigan","1395313553","5178410    ","050","00","2","3","26155","26","155",71687,70844,843,467,376
"Tuscola County","Tuscola County, Michigan","2104180663","262607294  ","050","00","2","3","26157","26","157",58266,57633,633,427,206
"Van Buren County","Van Buren County, Michigan","1582121725","1241456512 ","050","00","2","3","26159","26","159",76263,73560,2703,1009,1694
"Washtenaw County","Washtenaw County, Michigan","1838733615","32599676   ","050","00","2","3","26161","26","161",322895,289731,33164,10713,22451
"Wayne County","Wayne County, Michigan","1590646446","150352292  ","050","00","2","3","26163","26","163",2061162,1923393,137769,62926,74843
"Wexford County","Wexford County, Michigan","1464619961","26802646   ","050","00","2","3","26165","26","165",30484,29925,559,339,220
"Aitkin County","Aitkin County, Minnesota","4711959293","455872060  ","050","00","2","4","27001","27","001",15301,15158,143,86,57
"Anoka County","Anoka County, Minnesota","1097134871","58662784   ","050","00","2","4","27003","27","003",298084,287313,10771,5232,5539
"Becker County","Becker County, Minnesota","3393969725","348838046  ","050","00","2","4","27005","27","005",30000,29691,309,195,114
"Beltrami County","Beltrami County, Minnesota","6488621963","1425316120 ","050","00","2","4","27007","27","007",39650,38937,713,366,347
"Benton County","Benton County, Minnesota","1057430800","12232786   ","050","00","2","4","27009","27","009",34226,33494,732,272,460
"Big Stone County","Big Stone County, Minnesota","1287086601","80120966   ","050","00","2","4","27011","27","011",5820,5774,46,26,20
"Blue Earth County","Blue Earth County, Minnesota","1948598037","35067479   ","050","00","2","4","27013","27","013",55941,54313,1628,645,983
"Brown County","Brown County, Minnesota","1582130022","20048081   ","050","00","2","4","27015","27","015",26911,26572,339,193,146
"Carlton County","Carlton County, Minnesota","2228243943","38601965   ","050","00","2","4","27017","27","017",31671,31172,499,319,180
"Carver County","Carver County, Minnesota","924734562","49493783   ","050","00","2","4","27019","27","019",70205,67806,2399,900,1499
"Cass County","Cass County, Minnesota","5225549622","1027224890 ","050","00","2","4","27021","27","021",27150,26923,227,136,91
"Chippewa County","Chippewa County, Minnesota","1509450344","13013182   ","050","00","2","4","27023","27","023",13088,12910,178,104,74
"Chisago County","Chisago County, Minnesota","1081660196","64380708   ","050","00","2","4","27025","27","025",41101,40623,478,226,252
"Clay County","Clay County, Minnesota","2707168209","19409751   ","050","00","2","4","27027","27","027",51229,49890,1339,530,809
"Clearwater County","Clearwater County, Minnesota","2576286716","90848475   ","050","00","2","4","27029","27","029",8423,8344,79,58,21
"Cook County","Cook County, Minnesota","3757048990","4892778762 ","050","00","2","4","27031","27","031",5168,5030,138,69,69
"Cottonwood County","Cottonwood County, Minnesota","1657575598","23089123   ","050","00","2","4","27033","27","033",12167,11895,272,140,132
"Crow Wing County","Crow Wing County, Minnesota","2581099850","414386929  ","050","00","2","4","27035","27","035",55099,54444,655,400,255
"Dakota County","Dakota County, Minnesota","1475211060","43383381   ","050","00","2","4","27037","27","037",355904,337855,18049,8456,9593
"Dodge County","Dodge County, Minnesota","1138309077","316282     ","050","00","2","4","27039","27","039",17731,17287,444,181,263
"Douglas County","Douglas County, Minnesota","1642886292","221750557  ","050","00","2","4","27041","27","041",32821,32519,302,203,99
"Faribault County","Faribault County, Minnesota","1848292877","20678359   ","050","00","2","4","27043","27","043",16181,15926,255,87,168
"Fillmore County","Fillmore County, Minnesota","2230631415","2329971    ","050","00","2","4","27045","27","045",21122,20963,159,108,51
"Freeborn County","Freeborn County, Minnesota","1832782543","38823032   ","050","00","2","4","27047","27","047",32584,31573,1011,304,707
"Goodhue County","Goodhue County, Minnesota","1963911048","57408058   ","050","00","2","4","27049","27","049",44127,43615,512,240,272
"Grant County","Grant County, Minnesota","1415182450","74519039   ","050","00","2","4","27051","27","051",6289,6247,42,21,21
"Hennepin County","Hennepin County, Minnesota","1441631419","128895633  ","050","00","2","4","27053","27","053",1116200,1005704,110496,36519,73977
"Houston County","Houston County, Minnesota","1446264136","27193962   ","050","00","2","4","27055","27","055",19718,19506,212,95,117
"Hubbard County","Hubbard County, Minnesota","2389148050","199258510  ","050","00","2","4","27057","27","057",18376,18166,210,167,43
"Isanti County","Isanti County, Minnesota","1137181433","33168663   ","050","00","2","4","27059","27","059",31287,30879,408,220,188
"Itasca County","Itasca County, Minnesota","6902469547","680433374  ","050","00","2","4","27061","27","061",43992,43424,568,337,231
"Jackson County","Jackson County, Minnesota","1817374386","46010669   ","050","00","2","4","27063","27","063",11268,11104,164,41,123
"Kanabec County","Kanabec County, Minnesota","1359565637","21893102   ","050","00","2","4","27065","27","065",14996,14860,136,94,42
"Kandiyohi County","Kandiyohi County, Minnesota","2061780150","170719281  ","050","00","2","4","27067","27","067",41203,39656,1547,511,1036
"Kittson County","Kittson County, Minnesota","2841418760","16664830   ","050","00","2","4","27069","27","069",5285,5177,108,67,41
"Koochiching County","Koochiching County, Minnesota","8035072742","134583173  ","050","00","2","4","27071","27","071",14355,13514,841,536,305
"Lac qui Parle County","Lac qui Parle County, Minnesota","1980991269","34155792   ","050","00","2","4","27073","27","073",8067,7989,78,57,21
"Lake County","Lake County, Minnesota","5436798216","2309393470 ","050","00","2","4","27075","27","075",11058,10869,189,136,53
"Lake of the Woods County","Lake of the Woods County, Minnesota","3358447805","1238921565 ","050","00","2","4","27077","27","077",4522,4390,132,38,94
"Le Sueur County","Le Sueur County, Minnesota","1161608169","65680005   ","050","00","2","4","27079","27","079",25426,24967,459,140,319
"Lincoln County","Lincoln County, Minnesota","1390901199","29548223   ","050","00","2","4","27081","27","081",6429,6383,46,20,26
"Lyon County","Lyon County, Minnesota","1849701810","18872576   ","050","00","2","4","27083","27","083",25425,24275,1150,396,754
"McLeod County","McLeod County, Minnesota","1274036610","35632897   ","050","00","2","4","27085","27","085",34898,34114,784,369,415
"Mahnomen County","Mahnomen County, Minnesota","1440395658","69548161   ","050","00","2","4","27087","27","087",5190,5123,67,27,40
"Marshall County","Marshall County, Minnesota","4590085004","105024444  ","050","00","2","4","27089","27","089",10155,9965,190,75,115
"Martin County","Martin County, Minnesota","1837194705","52344900   ","050","00","2","4","27091","27","091",21802,21504,298,120,178
"Meeker County","Meeker County, Minnesota","1576115126","94646496   ","050","00","2","4","27093","27","093",22644,22458,186,77,109
"Mille Lacs County","Mille Lacs County, Minnesota","1487859492","277910248  ","050","00","2","4","27095","27","095",22330,22094,236,137,99
"Morrison County","Morrison County, Minnesota","2912435151","74650294   ","050","00","2","4","27097","27","097",31712,31404,308,220,88
"Mower County","Mower County, Minnesota","1842771214","543328     ","050","00","2","4","27099","27","099",38603,37210,1393,408,985
"Murray County","Murray County, Minnesota","1824466297","39074696   ","050","00","2","4","27101","27","101",9165,9037,128,42,86
"Nicollet County","Nicollet County, Minnesota","1171434445","37949515   ","050","00","2","4","27103","27","103",29771,28974,797,269,528
"Nobles County","Nobles County, Minnesota","1852841629","17971993   ","050","00","2","4","27105","27","105",20832,18951,1881,379,1502
"Norman County","Norman County, Minnesota","2269528709","1424031    ","050","00","2","4","27107","27","107",7442,7304,138,51,87
"Olmsted County","Olmsted County, Minnesota","1691289144","3864463    ","050","00","2","4","27109","27","109",124277,114519,9758,3224,6534
"Otter Tail County","Otter Tail County, Minnesota","5127422301","635074817  ","050","00","2","4","27111","27","111",57159,55993,1166,455,711
"Pennington County","Pennington County, Minnesota","1596835117","4668555    ","050","00","2","4","27113","27","113",13584,13360,224,75,149
"Pine County","Pine County, Minnesota","3654584453","60922040   ","050","00","2","4","27115","27","115",26530,26241,289,186,103
"Pipestone County","Pipestone County, Minnesota","1206638778","671275     ","050","00","2","4","27117","27","117",9895,9757,138,83,55
"Polk County","Polk County, Minnesota","5103237779","71062834   ","050","00","2","4","27119","27","119",31369,30669,700,244,456
"Pope County","Pope County, Minnesota","1735644816","122120574  ","050","00","2","4","27121","27","121",11236,11131,105,72,33
"Ramsey County","Ramsey County, Minnesota","403460947","37182419   ","050","00","2","4","27123","27","123",511035,456772,54263,18812,35451
"Red Lake County","Red Lake County, Minnesota","1119991223","211320     ","050","00","2","4","27125","27","125",4299,4251,48,30,18
"Redwood County","Redwood County, Minnesota","2278479819","3916517    ","050","00","2","4","27127","27","127",16815,16696,119,89,30
"Renville County","Renville County, Minnesota","2545749900","11135364   ","050","00","2","4","27129","27","129",17154,16802,352,97,255
"Rice County","Rice County, Minnesota","1288697315","48062967   ","050","00","2","4","27131","27","131",56665,53968,2697,688,2009
"Rock County","Rock County, Minnesota","1249952815","604756     ","050","00","2","4","27133","27","133",9721,9611,110,59,51
"Roseau County","Roseau County, Minnesota","4305891965","40973145   ","050","00","2","4","27135","27","135",16338,15888,450,213,237
"St. Louis County","St. Louis County, Minnesota","16123100792","1643989607 ","050","00","2","4","27137","27","137",200528,196631,3897,2624,1273
"Scott County","Scott County, Minnesota","923785607","30777540   ","050","00","2","4","27139","27","139",89498,85878,3620,1496,2124
"Sherburne County","Sherburne County, Minnesota","1130013623","38061083   ","050","00","2","4","27141","27","141",64417,63430,987,647,340
"Sibley County","Sibley County, Minnesota","1524594219","30461597   ","050","00","2","4","27143","27","143",15356,14960,396,77,319
"Stearns County","Stearns County, Minnesota","3482282738","117607351  ","050","00","2","4","27145","27","145",133166,130018,3148,1147,2001
"Steele County","Steele County, Minnesota","1112525378","6774348    ","050","00","2","4","27147","27","147",33680,32492,1188,395,793
"Stevens County","Stevens County, Minnesota","1455738964","34113610   ","050","00","2","4","27149","27","149",10053,9882,171,57,114
"Swift County","Swift County, Minnesota","1925733496","22847128   ","050","00","2","4","27151","27","151",11956,11810,146,53,93
"Todd County","Todd County, Minnesota","2439817277","96659676   ","050","00","2","4","27153","27","153",24426,23976,450,160,290
"Traverse County","Traverse County, Minnesota","1486880905","30743811   ","050","00","2","4","27155","27","155",4134,4105,29,21,8
"Wabasha County","Wabasha County, Minnesota","1359765254","64284463   ","050","00","2","4","27157","27","157",21610,21169,441,150,291
"Wadena County","Wadena County, Minnesota","1385686467","20668013   ","050","00","2","4","27159","27","159",13713,13580,133,98,35
"Waseca County","Waseca County, Minnesota","1096214300","24755374   ","050","00","2","4","27161","27","161",19526,19265,261,102,159
"Washington County","Washington County, Minnesota","1014508130","81479105   ","050","00","2","4","27163","27","163",201130,194270,6860,3709,3151
"Watonwan County","Watonwan County, Minnesota","1125386061","13993968   ","050","00","2","4","27165","27","165",11876,10927,949,149,800
"Wilkin County","Wilkin County, Minnesota","1946197091","505867     ","050","00","2","4","27167","27","167",7138,7089,49,18,31
"Winona County","Winona County, Minnesota","1622118131","39597458   ","050","00","2","4","27169","27","169",49985,48631,1354,499,855
"Wright County","Wright County, Minnesota","1711345644","138913443  ","050","00","2","4","27171","27","171",89986,89026,960,470,490
"Yellow Medicine County","Yellow Medicine County, Minnesota","1963095467","14069397   ","050","00","2","4","27173","27","173",11080,10944,136,64,72
"Adams County","Adams County, Mississippi","1192070645","67301035   ","050","00","3","6","28001","28","001",34340,33859,481,283,198
"Alcorn County","Alcorn County, Mississippi","1035717243","3786129    ","050","00","3","6","28003","28","003",34558,34210,348,136,212
"Amite County","Amite County, Mississippi","1889654265","5289854    ","050","00","3","6","28005","28","005",13599,13546,53,33,20
"Attala County","Attala County, Mississippi","1903968664","5109637    ","050","00","3","6","28007","28","007",19661,19508,153,8,145
"Benton County","Benton County, Mississippi","1053579121","4813918    ","050","00","3","6","28009","28","009",8026,7969,57,55,2
"Bolivar County","Bolivar County, Mississippi","2269566106","76332594   ","050","00","3","6","28011","28","011",40633,40428,205,106,99
"Calhoun County","Calhoun County, Mississippi","1519125834","3708838    ","050","00","3","6","28013","28","013",15069,14821,248,50,198
"Carroll County","Carroll County, Mississippi","1625822071","17641125   ","050","00","3","6","28015","28","015",10769,10681,88,51,37
"Chickasaw County","Chickasaw County, Mississippi","1299028121","7012569    ","050","00","3","6","28017","28","017",19440,19193,247,38,209
"Choctaw County","Choctaw County, Mississippi","1085464850","1842954    ","050","00","3","6","28019","28","019",9758,9724,34,16,18
"Claiborne County","Claiborne County, Mississippi","1260721976","37790312   ","050","00","3","6","28021","28","021",11831,11764,67,41,26
"Clarke County","Clarke County, Mississippi","1790373368","5552878    ","050","00","3","6","28023","28","023",17955,17893,62,29,33
"Clay County","Clay County, Mississippi","1058165124","19322346   ","050","00","3","6","28025","28","025",21979,21875,104,57,47
"Coahoma County","Coahoma County, Mississippi","1435246940","75077952   ","050","00","3","6","28027","28","027",30622,30349,273,104,169
"Copiah County","Copiah County, Mississippi","2011389312","7204911    ","050","00","3","6","28029","28","029",28757,28532,225,132,93
"Covington County","Covington County, Mississippi","1071711523","2968480    ","050","00","3","6","28031","28","031",19407,19290,117,31,86
"DeSoto County","DeSoto County, Mississippi","1237658020","48969960   ","050","00","3","6","28033","28","033",107199,105148,2051,703,1348
"Forrest County","Forrest County, Mississippi","1208428793","9306218    ","050","00","3","6","28035","28","035",72604,71148,1456,353,1103
"Franklin County","Franklin County, Mississippi","1462295484","5549555    ","050","00","3","6","28037","28","037",8448,8421,27,24,3
"George County","George County, Mississippi","1238770707","13829482   ","050","00","3","6","28039","28","039",19144,18900,244,46,198
"Greene County","Greene County, Mississippi","1846191653","15200286   ","050","00","3","6","28041","28","041",13299,13259,40,15,25
"Grenada County","Grenada County, Mississippi","1092436773","71443874   ","050","00","3","6","28043","28","043",23263,23031,232,52,180
"Hancock County","Hancock County, Mississippi","1235105235","195932047  ","050","00","3","6","28045","28","045",42967,42378,589,330,259
"Harrison County","Harrison County, Mississippi","1504734433","1023487219 ","050","00","3","6","28047","28","047",189601,182816,6785,3501,3284
"Hinds County","Hinds County, Mississippi","2251177952","21139090   ","050","00","3","6","28049","28","049",250800,248118,2682,1189,1493
"Holmes County","Holmes County, Mississippi","1958030490","21187799   ","050","00","3","6","28051","28","051",21609,21543,66,47,19
"Humphreys County","Humphreys County, Mississippi","1082845849","33855947   ","050","00","3","6","28053","28","053",11206,11116,90,36,54
"Issaquena County","Issaquena County, Mississippi","1069828803","73297767   ","050","00","3","6","28055","28","055",2274,2270,4,0,4
"Itawamba County","Itawamba County, Mississippi","1378668967","21009281   ","050","00","3","6","28057","28","057",22770,22628,142,92,50
"Jackson County","Jackson County, Mississippi","1882664931","819471367  ","050","00","3","6","28059","28","059",131420,127936,3484,1749,1735
"Jasper County","Jasper County, Mississippi","1750844450","3722581    ","050","00","3","6","28061","28","061",18149,18093,56,13,43
"Jefferson County","Jefferson County, Mississippi","1345206514","20216072   ","050","00","3","6","28063","28","063",9740,9714,26,13,13
"Jefferson Davis County","Jefferson Davis County, Mississippi","1057768074","1801783    ","050","00","3","6","28065","28","065",13962,13922,40,23,17
"Jones County","Jones County, Mississippi","1796973790","15315933   ","050","00","3","6","28067","28","067",64958,63644,1314,251,1063
"Kemper County","Kemper County, Mississippi","1984276268","2247467    ","050","00","3","6","28069","28","069",10453,10408,45,21,24
"Lafayette County","Lafayette County, Mississippi","1634576965","124767583  ","050","00","3","6","28071","28","071",38744,37826,918,252,666
"Lamar County","Lamar County, Mississippi","1287397446","8859751    ","050","00","3","6","28073","28","073",39070,38646,424,245,179
"Lauderdale County","Lauderdale County, Mississippi","1822081264","30477620   ","050","00","3","6","28075","28","075",78161,77579,582,276,306
"Lawrence County","Lawrence County, Mississippi","1115321358","13226346   ","050","00","3","6","28077","28","077",13258,13178,80,48,32
"Leake County","Leake County, Mississippi","1509204387","6954008    ","050","00","3","6","28079","28","079",20940,20649,291,92,199
"Lee County","Lee County, Mississippi","1164430094","9205378    ","050","00","3","6","28081","28","081",75755,74900,855,326,529
"Leflore County","Leflore County, Mississippi","1533085074","37357012   ","050","00","3","6","28083","28","083",37947,37541,406,83,323
"Lincoln County","Lincoln County, Mississippi","1516969745","6388993    ","050","00","3","6","28085","28","085",33166,32960,206,55,151
"Lowndes County","Lowndes County, Mississippi","1300941059","36652563   ","050","00","3","6","28087","28","087",61586,60805,781,373,408
"Madison County","Madison County, Mississippi","1857307939","64378471   ","050","00","3","6","28089","28","089",74674,73434,1240,743,497
"Marion County","Marion County, Mississippi","1404661267","16152148   ","050","00","3","6","28091","28","091",25595,25399,196,146,50
"Marshall County","Marshall County, Mississippi","1829376626","8996063    ","050","00","3","6","28093","28","093",34993,34647,346,116,230
"Monroe County","Monroe County, Mississippi","1979200505","20376807   ","050","00","3","6","28095","28","095",38014,37784,230,134,96
"Montgomery County","Montgomery County, Mississippi","1053724940","2633886    ","050","00","3","6","28097","28","097",12189,12161,28,18,10
"Neshoba County","Neshoba County, Mississippi","1476288200","4258230    ","050","00","3","6","28099","28","099",28684,28463,221,129,92
"Newton County","Newton County, Mississippi","1497097396","4005749    ","050","00","3","6","28101","28","101",21838,21730,108,52,56
"Noxubee County","Noxubee County, Mississippi","1799492506","13620129   ","050","00","3","6","28103","28","103",12548,12428,120,21,99
"Oktibbeha County","Oktibbeha County, Mississippi","1185463558","10860232   ","050","00","3","6","28105","28","105",42902,41481,1421,232,1189
"Panola County","Panola County, Mississippi","1772061994","54228381   ","050","00","3","6","28107","28","107",34274,34052,222,134,88
"Pearl River County","Pearl River County, Mississippi","2101334544","19691819   ","050","00","3","6","28109","28","109",48621,48018,603,348,255
"Perry County","Perry County, Mississippi","1676181841","7827251    ","050","00","3","6","28111","28","111",12138,12083,55,25,30
"Pike County","Pike County, Mississippi","1059017229","4908022    ","050","00","3","6","28113","28","113",38940,38580,360,175,185
"Pontotoc County","Pontotoc County, Mississippi","1288135081","9435479    ","050","00","3","6","28115","28","115",26726,26423,303,68,235
"Prentiss County","Prentiss County, Mississippi","1074654719","8587710    ","050","00","3","6","28117","28","117",25556,25466,90,51,39
"Quitman County","Quitman County, Mississippi","1048526519","4287253    ","050","00","3","6","28119","28","119",10117,10097,20,9,11
"Rankin County","Rankin County, Mississippi","2005987647","81771532   ","050","00","3","6","28121","28","121",115327,113518,1809,706,1103
"Scott County","Scott County, Mississippi","1577517758","3369823    ","050","00","3","6","28123","28","123",28423,27219,1204,183,1021
"Sharkey County","Sharkey County, Mississippi","1107765744","18578690   ","050","00","3","6","28125","28","125",6580,6555,25,11,14
"Simpson County","Simpson County, Mississippi","1524806607","4652740    ","050","00","3","6","28127","28","127",27639,27381,258,67,191
"Smith County","Smith County, Mississippi","1646940031","3571926    ","050","00","3","6","28129","28","129",16182,16105,77,19,58
"Stone County","Stone County, Mississippi","1153491942","7006457    ","050","00","3","6","28131","28","131",13622,13489,133,65,68
"Sunflower County","Sunflower County, Mississippi","1796908346","34771176   ","050","00","3","6","28133","28","133",34369,34149,220,76,144
"Tallahatchie County","Tallahatchie County, Mississippi","1667749261","21131570   ","050","00","3","6","28135","28","135",14903,14825,78,29,49
"Tate County","Tate County, Mississippi","1047595981","16755446   ","050","00","3","6","28137","28","137",25370,25324,46,24,22
"Tippah County","Tippah County, Mississippi","1185968757","5350291    ","050","00","3","6","28139","28","139",20826,20429,397,79,318
"Tishomingo County","Tishomingo County, Mississippi","1098477263","52867858   ","050","00","3","6","28141","28","141",19163,18972,191,50,141
"Tunica County","Tunica County, Mississippi","1177949335","67268272   ","050","00","3","6","28143","28","143",9227,9147,80,9,71
"Union County","Union County, Mississippi","1075960153","3737118    ","050","00","3","6","28145","28","145",25362,24913,449,194,255
"Walthall County","Walthall County, Mississippi","1045891461","1607359    ","050","00","3","6","28147","28","147",15156,15079,77,40,37
"Warren County","Warren County, Mississippi","1519315953","83273338   ","050","00","3","6","28149","28","149",49644,49047,597,313,284
"Washington County","Washington County, Mississippi","1875115658","96530085   ","050","00","3","6","28151","28","151",62977,62447,530,191,339
"Wayne County","Wayne County, Mississippi","2098730646","8234910    ","050","00","3","6","28153","28","153",21216,21147,69,32,37
"Webster County","Webster County, Mississippi","1094250516","2200025    ","050","00","3","6","28155","28","155",10294,10240,54,20,34
"Wilkinson County","Wilkinson County, Mississippi","1752656682","28364594   ","050","00","3","6","28157","28","157",10312,10305,7,5,2
"Winston County","Winston County, Mississippi","1572043155","8124929    ","050","00","3","6","28159","28","159",20160,19940,220,106,114
"Yalobusha County","Yalobusha County, Mississippi","1209835322","72210847   ","050","00","3","6","28161","28","161",13051,13000,51,15,36
"Yazoo County","Yazoo County, Mississippi","2381447909","37917610   ","050","00","3","6","28163","28","163",28149,27054,1095,85,1010
"Adair County","Adair County, Missouri","1468536034","5991075    ","050","00","2","4","29001","29","001",24977,24485,492,228,264
"Andrew County","Andrew County, Missouri","1127118980","3413268    ","050","00","2","4","29003","29","003",16492,16389,103,42,61
"Atchison County","Atchison County, Missouri","1410812102","6846598    ","050","00","2","4","29005","29","005",6430,6408,22,9,13
"Audrain County","Audrain County, Missouri","1795109951","9562612    ","050","00","2","4","29007","29","007",25853,25667,186,120,66
"Barry County","Barry County, Missouri","2017764979","30641378   ","050","00","2","4","29009","29","009",34010,32827,1183,313,870
"Barton County","Barton County, Missouri","1539100279","6405206    ","050","00","2","4","29011","29","011",12541,12452,89,32,57
"Bates County","Bates County, Missouri","2197517820","7511755    ","050","00","2","4","29013","29","013",16653,16502,151,83,68
"Benton County","Benton County, Missouri","1827267325","121655908  ","050","00","2","4","29015","29","015",17180,17067,113,63,50
"Bollinger County","Bollinger County, Missouri","1607712588","1187198    ","050","00","2","4","29017","29","017",12029,11981,48,30,18
"Boone County","Boone County, Missouri","1775255762","15231715   ","050","00","2","4","29019","29","019",135454,129312,6142,1829,4313
"Buchanan County","Buchanan County, Missouri","1061196940","12532387   ","050","00","2","4","29021","29","021",85998,85079,919,572,347
"Butler County","Butler County, Missouri","1806618349","3708503    ","050","00","2","4","29023","29","023",40867,40288,579,264,315
"Caldwell County","Caldwell County, Missouri","1111989322","973959     ","050","00","2","4","29025","29","025",8969,8931,38,24,14
"Callaway County","Callaway County, Missouri","2172575802","21222566   ","050","00","2","4","29027","29","027",40766,40333,433,191,242
"Camden County","Camden County, Missouri","1696812047","139118534  ","050","00","2","4","29029","29","029",37051,36521,530,272,258
"Cape Girardeau County","Cape Girardeau County, Missouri","1498617560","19863617   ","050","00","2","4","29031","29","031",68693,67780,913,363,550
"Carroll County","Carroll County, Missouri","1799322240","19614104   ","050","00","2","4","29033","29","033",10285,10239,46,42,4
"Carter County","Carter County, Missouri","1314634094","3728720    ","050","00","2","4","29035","29","035",5941,5926,15,9,6
"Cass County","Cass County, Missouri","1810377121","9539683    ","050","00","2","4","29037","29","037",82092,80780,1312,620,692
"Cedar County","Cedar County, Missouri","1232661657","58465173   ","050","00","2","4","29039","29","039",13733,13555,178,147,31
"Chariton County","Chariton County, Missouri","1957696063","32073368   ","050","00","2","4","29041","29","041",8438,8385,53,32,21
"Christian County","Christian County, Missouri","1458579651","2303985    ","050","00","2","4","29043","29","043",54285,53820,465,279,186
"Clark County","Clark County, Missouri","1313929257","11885150   ","050","00","2","4","29045","29","045",7416,7398,18,14,4
"Clay County","Clay County, Missouri","1026537131","32414613   ","050","00","2","4","29047","29","047",184006,178745,5261,2163,3098
"Clinton County","Clinton County, Missouri","1084589558","12199274   ","050","00","2","4","29049","29","049",18979,18881,98,72,26
"Cole County","Cole County, Missouri","1013835684","19775219   ","050","00","2","4","29051","29","051",71397,69827,1570,550,1020
"Cooper County","Cooper County, Missouri","1463416719","13446888   ","050","00","2","4","29053","29","053",16670,16571,99,69,30
"Crawford County","Crawford County, Missouri","1923112450","3284401    ","050","00","2","4","29055","29","055",22804,22537,267,111,156
"Dade County","Dade County, Missouri","1269977968","41336247   ","050","00","2","4","29057","29","057",7923,7844,79,59,20
"Dallas County","Dallas County, Missouri","1402590401","3344776    ","050","00","2","4","29059","29","059",15661,15581,80,57,23
"Daviess County","Daviess County, Missouri","1468438424","5457104    ","050","00","2","4","29061","29","061",8016,7998,18,11,7
"DeKalb County","DeKalb County, Missouri","1098669767","4064624    ","050","00","2","4","29063","29","063",11597,11478,119,39,80
"Dent County","Dent County, Missouri","1951656029","2521547    ","050","00","2","4","29065","29","065",14927,14831,96,62,34
"Douglas County","Douglas County, Missouri","2109626931","189771     ","050","00","2","4","29067","29","067",13084,12964,120,54,66
"Dunklin County","Dunklin County, Missouri","1413148910","3867564    ","050","00","2","4","29069","29","069",33155,32668,487,102,385
"Franklin County","Franklin County, Missouri","2390068207","20313536   ","050","00","2","4","29071","29","071",93807,93057,750,511,239
"Gasconade County","Gasconade County, Missouri","1348525009","14054682   ","050","00","2","4","29073","29","073",15342,15259,83,71,12
"Gentry County","Gentry County, Missouri","1273034821","740807     ","050","00","2","4","29075","29","075",6861,6817,44,9,35
"Greene County","Greene County, Missouri","1748172744","7309596    ","050","00","2","4","29077","29","077",240391,235904,4487,2118,2369
"Grundy County","Grundy County, Missouri","1128761096","5600644    ","050","00","2","4","29079","29","079",10432,10286,146,60,86
"Harrison County","Harrison County, Missouri","1878075926","3429152    ","050","00","2","4","29081","29","081",8850,8765,85,25,60
"Henry County","Henry County, Missouri","1819425235","77881861   ","050","00","2","4","29083","29","083",21997,21816,181,58,123
"Hickory County","Hickory County, Missouri","1032442304","33954526   ","050","00","2","4","29085","29","085",8940,8852,88,52,36
"Holt County","Holt County, Missouri","1196228316","18607154   ","050","00","2","4","29087","29","087",5351,5327,24,17,7
"Howard County","Howard County, Missouri","1206248485","12474394   ","050","00","2","4","29089","29","089",10212,10112,100,39,61
"Howell County","Howell County, Missouri","2402837046","1515991    ","050","00","2","4","29091","29","091",37238,36750,488,203,285
"Iron County","Iron County, Missouri","1427961482","1848581    ","050","00","2","4","29093","29","093",10697,10657,40,26,14
"Jackson County","Jackson County, Missouri","1566539191","29958289   ","050","00","2","4","29095","29","095",654880,626560,28320,10043,18277
"Jasper County","Jasper County, Missouri","1656900802","4114195    ","050","00","2","4","29097","29","097",104686,101939,2747,843,1904
"Jefferson County","Jefferson County, Missouri","1701094116","18882037   ","050","00","2","4","29099","29","099",198099,196156,1943,1107,836
"Johnson County","Johnson County, Missouri","2150829433","6699248    ","050","00","2","4","29101","29","101",48258,46800,1458,465,993
"Knox County","Knox County, Missouri","1309775019","2762900    ","050","00","2","4","29103","29","103",4361,4350,11,9,2
"Laclede County","Laclede County, Missouri","1983551776","5551785    ","050","00","2","4","29105","29","105",32513,32223,290,129,161
"Lafayette County","Lafayette County, Missouri","1629909909","24725921   ","050","00","2","4","29107","29","107",32960,32722,238,121,117
"Lawrence County","Lawrence County, Missouri","1587858749","784697     ","050","00","2","4","29109","29","109",35204,34385,819,243,576
"Lewis County","Lewis County, Missouri","1307962688","15140208   ","050","00","2","4","29111","29","111",10494,10430,64,32,32
"Lincoln County","Lincoln County, Missouri","1632962085","25702388   ","050","00","2","4","29113","29","113",38944,38727,217,89,128
"Linn County","Linn County, Missouri","1606703893","2878291    ","050","00","2","4","29115","29","115",13754,13669,85,33,52
"Livingston County","Livingston County, Missouri","1384408740","10235894   ","050","00","2","4","29117","29","117",14558,14501,57,13,44
"McDonald County","McDonald County, Missouri","1397328580","496335     ","050","00","2","4","29119","29","119",21681,20466,1215,213,1002
"Macon County","Macon County, Missouri","2081750779","22694686   ","050","00","2","4","29121","29","121",15762,15713,49,19,30
"Madison County","Madison County, Missouri","1286528020","2253278    ","050","00","2","4","29123","29","123",11800,11709,91,55,36
"Maries County","Maries County, Missouri","1366808854","5816347    ","050","00","2","4","29125","29","125",8903,8836,67,47,20
"Marion County","Marion County, Missouri","1134607993","15468000   ","050","00","2","4","29127","29","127",28289,28069,220,92,128
"Mercer County","Mercer County, Missouri","1176310082","2593970    ","050","00","2","4","29129","29","129",3757,3741,16,7,9
"Miller County","Miller County, Missouri","1533933921","19904916   ","050","00","2","4","29131","29","131",23564,23402,162,106,56
"Mississippi County","Mississippi County, Missouri","1070070578","40790949   ","050","00","2","4","29133","29","133",13427,13358,69,37,32
"Moniteau County","Moniteau County, Missouri","1078778015","6031716    ","050","00","2","4","29135","29","135",14827,14591,236,83,153
"Monroe County","Monroe County, Missouri","1673085704","62791636   ","050","00","2","4","29137","29","137",9311,9261,50,25,25
"Montgomery County","Montgomery County, Missouri","1392020046","7461478    ","050","00","2","4","29139","29","139",12136,11986,150,100,50
"Morgan County","Morgan County, Missouri","1547290919","42683952   ","050","00","2","4","29141","29","141",19309,19112,197,55,142
"New Madrid County","New Madrid County, Missouri","1756039541","51815220   ","050","00","2","4","29143","29","143",19760,19697,63,40,23
"Newton County","Newton County, Missouri","1622411544","631006     ","050","00","2","4","29145","29","145",52636,51888,748,275,473
"Nodaway County","Nodaway County, Missouri","2270434775","2938804    ","050","00","2","4","29147","29","147",21912,21614,298,125,173
"Oregon County","Oregon County, Missouri","2049724380","473825     ","050","00","2","4","29149","29","149",10344,10270,74,22,52
"Osage County","Osage County, Missouri","1569810055","18905430   ","050","00","2","4","29151","29","151",13062,13003,59,38,21
"Ozark County","Ozark County, Missouri","1922154443","33462813   ","050","00","2","4","29153","29","153",9542,9446,96,59,37
"Pemiscot County","Pemiscot County, Missouri","1277066344","50062733   ","050","00","2","4","29155","29","155",20047,19862,185,66,119
"Perry County","Perry County, Missouri","1229383442","24887043   ","050","00","2","4","29157","29","157",18132,17925,207,139,68
"Pettis County","Pettis County, Missouri","1773687006","3934038    ","050","00","2","4","29159","29","159",39403,38245,1158,273,885
"Phelps County","Phelps County, Missouri","1742678646","3704611    ","050","00","2","4","29161","29","161",39825,38239,1586,486,1100
"Pike County","Pike County, Missouri","1742604079","31043265   ","050","00","2","4","29163","29","163",18351,18063,288,37,251
"Platte County","Platte County, Missouri","1088655061","17850300   ","050","00","2","4","29165","29","165",73781,71039,2742,1175,1567
"Polk County","Polk County, Missouri","1650349677","13624303   ","050","00","2","4","29167","29","167",26992,26596,396,187,209
"Pulaski County","Pulaski County, Missouri","1416774891","11359773   ","050","00","2","4","29169","29","169",41165,39198,1967,1228,739
"Putnam County","Putnam County, Missouri","1341346201","4554188    ","050","00","2","4","29171","29","171",5223,5196,27,27,0
"Ralls County","Ralls County, Missouri","1219879778","33200118   ","050","00","2","4","29173","29","173",9626,9593,33,20,13
"Randolph County","Randolph County, Missouri","1249200593","13808406   ","050","00","2","4","29175","29","175",24663,24334,329,108,221
"Ray County","Ray County, Missouri","1474908728","10641357   ","050","00","2","4","29177","29","177",23354,23263,91,25,66
"Reynolds County","Reynolds County, Missouri","2100993071","8323460    ","050","00","2","4","29179","29","179",6689,6662,27,15,12
"Ripley County","Ripley County, Missouri","1630308640","5689704    ","050","00","2","4","29181","29","181",13509,13363,146,77,69
"St. Charles County","St. Charles County, Missouri","1451484650","82690700   ","050","00","2","4","29183","29","183",283883,278042,5841,2921,2920
"St. Clair County","St. Clair County, Missouri","1752530410","65390605   ","050","00","2","4","29185","29","185",9652,9587,65,56,9
"Ste. Genevieve County","Ste. Genevieve County, Missouri","1301180929","16958205   ","050","00","2","4","29186","29","186",17842,17731,111,65,46
"St. Francois County","St. Francois County, Missouri","1164106452","7609408    ","050","00","2","4","29187","29","187",55641,55148,493,248,245
"St. Louis County","St. Louis County, Missouri","1315210013","41151542   ","050","00","2","4","29189","29","189",1016315,973613,42702,20781,21921
"Saline County","Saline County, Missouri","1956864345","23403673   ","050","00","2","4","29195","29","195",23756,22932,824,172,652
"Schuyler County","Schuyler County, Missouri","797375479","746110     ","050","00","2","4","29197","29","197",4170,4153,17,8,9
"Scotland County","Scotland County, Missouri","1135619670","2034296    ","050","00","2","4","29199","29","199",4983,4966,17,12,5
"Scott County","Scott County, Missouri","1090411521","13016370   ","050","00","2","4","29201","29","201",40422,40192,230,96,134
"Shannon County","Shannon County, Missouri","2599912726","397876     ","050","00","2","4","29203","29","203",8324,8285,39,31,8
"Shelby County","Shelby County, Missouri","1297415094","3871228    ","050","00","2","4","29205","29","205",6799,6745,54,18,36
"Stoddard County","Stoddard County, Missouri","2142239844","4708302    ","050","00","2","4","29207","29","207",29705,29571,134,52,82
"Stone County","Stone County, Missouri","1199745263","123495506  ","050","00","2","4","29209","29","209",28658,28329,329,215,114
"Sullivan County","Sullivan County, Missouri","1685949286","1244196    ","050","00","2","4","29211","29","211",7219,6798,421,96,325
"Taney County","Taney County, Missouri","1637793873","49522782   ","050","00","2","4","29213","29","213",39703,38901,802,461,341
"Texas County","Texas County, Missouri","3052393520","1815685    ","050","00","2","4","29215","29","215",23003,22814,189,92,97
"Vernon County","Vernon County, Missouri","2159928871","7999080    ","050","00","2","4","29217","29","217",20454,20198,256,80,176
"Warren County","Warren County, Missouri","1117098314","16640801   ","050","00","2","4","29219","29","219",24525,24155,370,182,188
"Washington County","Washington County, Missouri","1967340061","7424395    ","050","00","2","4","29221","29","221",23344,23187,157,88,69
"Wayne County","Wayne County, Missouri","1971069669","33811008   ","050","00","2","4","29223","29","223",13259,13213,46,13,33
"Webster County","Webster County, Missouri","1536680599","958466     ","050","00","2","4","29225","29","225",31045,30782,263,166,97
"Worth County","Worth County, Missouri","690283622","603460     ","050","00","2","4","29227","29","227",2382,2377,5,5,0
"Wright County","Wright County, Missouri","1766698058","2732295    ","050","00","2","4","29229","29","229",17955,17795,160,76,84
"St. Louis city","St. Louis city, Missouri","160381752","10942983   ","050","00","2","4","29510","29","510",348189,328647,19542,5348,14194
"Beaverhead County","Beaverhead County, Montana","14354507338","77006992   ","050","00","4","8","30001","30","001",9202,9055,147,70,77
"Big Horn County","Big Horn County, Montana","12936490124","51388018   ","050","00","4","8","30003","30","003",12671,12569,102,55,47
"Blaine County","Blaine County, Montana","10945752903","32989204   ","050","00","4","8","30005","30","005",7009,6912,97,74,23
"Broadwater County","Broadwater County, Montana","3085580464","123251566  ","050","00","4","8","30007","30","007",4385,4323,62,19,43
"Carbon County","Carbon County, Montana","5304272289","36765246   ","050","00","4","8","30009","30","009",9552,9400,152,66,86
"Carter County","Carter County, Montana","8649437259","22606246   ","050","00","4","8","30011","30","011",1360,1347,13,8,5
"Cascade County","Cascade County, Montana","6987537964","35607133   ","050","00","4","8","30013","30","013",80357,78454,1903,1208,695
"Chouteau County","Chouteau County, Montana","10290645171","61536507   ","050","00","4","8","30015","30","015",5970,5857,113,75,38
"Custer County","Custer County, Montana","9798251384","26134225   ","050","00","4","8","30017","30","017",11696,11534,162,93,69
"Daniels County","Daniels County, Montana","3693546521","1116694    ","050","00","4","8","30019","30","019",2017,1922,95,68,27
"Dawson County","Dawson County, Montana","6146398431","25876705   ","050","00","4","8","30021","30","021",9059,8957,102,66,36
"Deer Lodge County","Deer Lodge County, Montana","1908765391","10841294   ","050","00","4","8","30023","30","023",9417,9283,134,103,31
"Fallon County","Fallon County, Montana","4196635352","6964830    ","050","00","4","8","30025","30","025",2837,2810,27,18,9
"Fergus County","Fergus County, Montana","11238392924","28999417   ","050","00","4","8","30027","30","027",11893,11774,119,80,39
"Flathead County","Flathead County, Montana","13204631512","409512577  ","050","00","4","8","30029","30","029",74471,72886,1585,875,710
"Gallatin County","Gallatin County, Montana","6749099493","67332992   ","050","00","4","8","30031","30","031",67831,65993,1838,815,1023
"Garfield County","Garfield County, Montana","12090225656","464853285  ","050","00","4","8","30033","30","033",1279,1265,14,6,8
"Glacier County","Glacier County, Montana","7756282905","109788368  ","050","00","4","8","30035","30","035",13247,12967,280,200,80
"Golden Valley County","Golden Valley County, Montana","3044021211","2841602    ","050","00","4","8","30037","30","037",1042,1015,27,23,4
"Granite County","Granite County, Montana","4474059524","14683527   ","050","00","4","8","30039","30","039",2830,2802,28,10,18
"Hill County","Hill County, Montana","7501540796","50986945   ","050","00","4","8","30041","30","041",16673,16341,332,284,48
"Jefferson County","Jefferson County, Montana","4290668205","5680515    ","050","00","4","8","30043","30","043",10049,9946,103,59,44
"Judith Basin County","Judith Basin County, Montana","4842881193","2233827    ","050","00","4","8","30045","30","045",2329,2297,32,15,17
"Lake County","Lake County, Montana","3868856367","414259580  ","050","00","4","8","30047","30","047",26507,26080,427,261,166
"Lewis and Clark County","Lewis and Clark County, Montana","8963842986","94796685   ","050","00","4","8","30049","30","049",55716,54820,896,509,387
"Liberty County","Liberty County, Montana","3703057430","45158524   ","050","00","4","8","30051","30","051",2158,2128,30,26,4
"Lincoln County","Lincoln County, Montana","9356768784","161719030  ","050","00","4","8","30053","30","053",18837,18571,266,194,72
"McCone County","McCone County, Montana","6844108488","104236769  ","050","00","4","8","30055","30","055",1977,1964,13,8,5
"Madison County","Madison County, Montana","9289094981","42235337   ","050","00","4","8","30057","30","057",6851,6753,98,59,39
"Meagher County","Meagher County, Montana","6194773413","7819839    ","050","00","4","8","30059","30","059",1932,1898,34,24,10
"Mineral County","Mineral County, Montana","3159321942","9211588    ","050","00","4","8","30061","30","061",3884,3827,57,39,18
"Missoula County","Missoula County, Montana","6728702048","52766899   ","050","00","4","8","30063","30","063",95802,93606,2196,1207,989
"Musselshell County","Musselshell County, Montana","4835889369","9749881    ","050","00","4","8","30065","30","065",4497,4409,88,45,43
"Park County","Park County, Montana","7258210526","28946363   ","050","00","4","8","30067","30","067",15694,15276,418,157,261
"Petroleum County","Petroleum County, Montana","4283590695","52086808   ","050","00","4","8","30069","30","069",493,490,3,3,0
"Phillips County","Phillips County, Montana","13311420195","188038143  ","050","00","4","8","30071","30","071",4601,4553,48,30,18
"Pondera County","Pondera County, Montana","4207949013","39255346   ","050","00","4","8","30073","30","073",6424,6321,103,85,18
"Powder River County","Powder River County, Montana","8539650552","1965936    ","050","00","4","8","30075","30","075",1858,1846,12,10,2
"Powell County","Powell County, Montana","6024160554","17455470   ","050","00","4","8","30077","30","077",7180,7134,46,34,12
"Prairie County","Prairie County, Montana","4497646015","15551784   ","050","00","4","8","30079","30","079",1199,1185,14,14,0
"Ravalli County","Ravalli County, Montana","6200979524","15823669   ","050","00","4","8","30081","30","081",36070,35467,603,342,261
"Richland County","Richland County, Montana","5397767654","49030770   ","050","00","4","8","30083","30","083",9667,9527,140,50,90
"Roosevelt County","Roosevelt County, Montana","6100980072","36381259   ","050","00","4","8","30085","30","085",10620,10527,93,47,46
"Rosebud County","Rosebud County, Montana","12981972794","37733032   ","050","00","4","8","30087","30","087",9383,9279,104,43,61
"Sanders County","Sanders County, Montana","7153992364","72152060   ","050","00","4","8","30089","30","089",10227,10024,203,80,123
"Sheridan County","Sheridan County, Montana","4342318338","76989171   ","050","00","4","8","30091","30","091",4105,4029,76,37,39
"Silver Bow County","Silver Bow County, Montana","1860409529","1722132    ","050","00","4","8","30093","30","093",34606,34063,543,337,206
"Stillwater County","Stillwater County, Montana","4649256643","24660760   ","050","00","4","8","30095","30","095",8195,8073,122,61,61
"Sweet Grass County","Sweet Grass County, Montana","4804645075","17919254   ","050","00","4","8","30097","30","097",3609,3548,61,37,24
"Teton County","Teton County, Montana","5886038319","51712382   ","050","00","4","8","30099","30","099",6445,6351,94,56,38
"Toole County","Toole County, Montana","4949343018","90423935   ","050","00","4","8","30101","30","101",5267,5078,189,122,67
"Treasure County","Treasure County, Montana","2535246850","13578705   ","050","00","4","8","30103","30","103",861,854,7,6,1
"Valley County","Valley County, Montana","12745321151","365142335  ","050","00","4","8","30105","30","105",7675,7588,87,68,19
"Wheatland County","Wheatland County, Montana","3685791858","13454305   ","050","00","4","8","30107","30","107",2259,2193,66,59,7
"Wibaux County","Wibaux County, Montana","2303308810","2017351    ","050","00","4","8","30109","30","109",1068,1053,15,8,7
"Yellowstone County","Yellowstone County, Montana","6825018002","35996187   ","050","00","4","8","30111","30","111",129352,127575,1777,1134,643
"Adams County","Adams County, Nebraska","1459219777","1956443    ","050","00","2","4","31001","31","001",31151,29786,1365,269,1096
"Antelope County","Antelope County, Nebraska","2219773879","3546750    ","050","00","2","4","31003","31","003",7452,7421,31,25,6
"Arthur County","Arthur County, Nebraska","1852798266","7632662    ","050","00","2","4","31005","31","005",444,441,3,1,2
"Banner County","Banner County, Nebraska","1932693329","398806     ","050","00","2","4","31007","31","007",819,812,7,4,3
"Blaine County","Blaine County, Nebraska","1840816942","9306070    ","050","00","2","4","31009","31","009",583,581,2,2,0
"Boone County","Boone County, Nebraska","1778516636","1443691    ","050","00","2","4","31011","31","011",6259,6201,58,42,16
"Box Butte County","Box Butte County, Nebraska","2784992667","6587161    ","050","00","2","4","31013","31","013",12158,11780,378,167,211
"Boyd County","Boyd County, Nebraska","1398720124","11768888   ","050","00","2","4","31015","31","015",2438,2428,10,10,0
"Brown County","Brown County, Nebraska","3163099102","9833856    ","050","00","2","4","31017","31","017",3525,3501,24,16,8
"Buffalo County","Buffalo County, Nebraska","2507092913","18844970   ","050","00","2","4","31019","31","019",42259,41162,1097,380,717
"Burt County","Burt County, Nebraska","1276259996","11216220   ","050","00","2","4","31021","31","021",7791,7708,83,26,57
"Butler County","Butler County, Nebraska","1511485301","2123917    ","050","00","2","4","31023","31","023",8767,8688,79,30,49
"Cass County","Cass County, Nebraska","1448279901","18196849   ","050","00","2","4","31025","31","025",24334,24037,297,164,133
"Cedar County","Cedar County, Nebraska","1917176338","14468136   ","050","00","2","4","31027","31","027",9615,9575,40,25,15
"Chase County","Chase County, Nebraska","2316731656","8130506    ","050","00","2","4","31029","31","029",4068,4012,56,17,39
"Cherry County","Cherry County, Nebraska","15437682699","126960902  ","050","00","2","4","31031","31","031",6148,6104,44,20,24
"Cheyenne County","Cheyenne County, Nebraska","3098510887","292553     ","050","00","2","4","31033","31","033",9830,9739,91,46,45
"Clay County","Clay County, Nebraska","1484148466","1275460    ","050","00","2","4","31035","31","035",7039,6859,180,61,119
"Colfax County","Colfax County, Nebraska","1070035295","14094150   ","050","00","2","4","31037","31","037",10441,8539,1902,493,1409
"Cuming County","Cuming County, Nebraska","1481474666","6579987    ","050","00","2","4","31039","31","039",10203,9817,386,103,283
"Custer County","Custer County, Nebraska","6671055928","949961     ","050","00","2","4","31041","31","041",11793,11744,49,18,31
"Dakota County","Dakota County, Nebraska","683229756","9312554    ","050","00","2","4","31043","31","043",20253,17084,3169,761,2408
"Dawes County","Dawes County, Nebraska","3616246664","11958234   ","050","00","2","4","31045","31","045",9060,8862,198,58,140
"Dawson County","Dawson County, Nebraska","2623453847","16508629   ","050","00","2","4","31047","31","047",24365,20499,3866,913,2953
"Deuel County","Deuel County, Nebraska","1139321050","2320125    ","050","00","2","4","31049","31","049",2098,2080,18,10,8
"Dixon County","Dixon County, Nebraska","1233833402","16404913   ","050","00","2","4","31051","31","051",6339,6121,218,54,164
"Dodge County","Dodge County, Nebraska","1384074735","24681283   ","050","00","2","4","31053","31","053",36160,35163,997,321,676
"Douglas County","Douglas County, Nebraska","857229815","22331145   ","050","00","2","4","31055","31","055",463585,436167,27418,8445,18973
"Dundy County","Dundy County, Nebraska","2382425157","2417854    ","050","00","2","4","31057","31","057",2292,2248,44,13,31
"Fillmore County","Fillmore County, Nebraska","1493023744","410198     ","050","00","2","4","31059","31","059",6634,6584,50,28,22
"Franklin County","Franklin County, Nebraska","1491630108","487893     ","050","00","2","4","31061","31","061",3574,3553,21,2,19
"Frontier County","Frontier County, Nebraska","2524071575","14274992   ","050","00","2","4","31063","31","063",3099,3069,30,19,11
"Furnas County","Furnas County, Nebraska","1859835110","6279784    ","050","00","2","4","31065","31","065",5324,5306,18,8,10
"Gage County","Gage County, Nebraska","2215184470","12043138   ","050","00","2","4","31067","31","067",22993,22828,165,82,83
"Garden County","Garden County, Nebraska","4414372932","68885095   ","050","00","2","4","31069","31","069",2292,2271,21,19,2
"Garfield County","Garfield County, Nebraska","1476366723","3392519    ","050","00","2","4","31071","31","071",1902,1889,13,7,6
"Gosper County","Gosper County, Nebraska","1186667805","11833757   ","050","00","2","4","31073","31","073",2143,2132,11,6,5
"Grant County","Grant County, Nebraska","2010412262","18132573   ","050","00","2","4","31075","31","075",747,739,8,5,3
"Greeley County","Greeley County, Nebraska","1475914080","2207228    ","050","00","2","4","31077","31","077",2714,2696,18,12,6
"Hall County","Hall County, Nebraska","1415161208","15092791   ","050","00","2","4","31079","31","079",53534,49067,4467,927,3540
"Hamilton County","Hamilton County, Nebraska","1408113575","8007677    ","050","00","2","4","31081","31","081",9403,9366,37,7,30
"Harlan County","Harlan County, Nebraska","1431701895","55421567   ","050","00","2","4","31083","31","083",3786,3773,13,12,1
"Hayes County","Hayes County, Nebraska","1846957473","570786     ","050","00","2","4","31085","31","085",1068,1047,21,8,13
"Hitchcock County","Hitchcock County, Nebraska","1838965336","22124480   ","050","00","2","4","31087","31","087",3111,3075,36,20,16
"Holt County","Holt County, Nebraska","6248754768","12930868   ","050","00","2","4","31089","31","089",11551,11460,91,50,41
"Hooker County","Hooker County, Nebraska","1867810427","882999     ","050","00","2","4","31091","31","091",783,783,0,0,0
"Howard County","Howard County, Nebraska","1474917271","16247192   ","050","00","2","4","31093","31","093",6567,6517,50,22,28
"Jefferson County","Jefferson County, Nebraska","1484101954","6424980    ","050","00","2","4","31095","31","095",8333,8299,34,13,21
"Johnson County","Johnson County, Nebraska","974173497","1781896    ","050","00","2","4","31097","31","097",4488,4294,194,79,115
"Kearney County","Kearney County, Nebraska","1336508766","272320     ","050","00","2","4","31099","31","099",6882,6771,111,39,72
"Keith County","Keith County, Nebraska","2748645011","125640923  ","050","00","2","4","31101","31","101",8875,8722,153,71,82
"Keya Paha County","Keya Paha County, Nebraska","2002803647","2293481    ","050","00","2","4","31103","31","103",983,961,22,22,0
"Kimball County","Kimball County, Nebraska","2464952386","1509659    ","050","00","2","4","31105","31","105",4089,4059,30,20,10
"Knox County","Knox County, Nebraska","2870014677","81672526   ","050","00","2","4","31107","31","107",9374,9284,90,68,22
"Lancaster County","Lancaster County, Nebraska","2172691291","20275749   ","050","00","2","4","31109","31","109",250291,236721,13570,4363,9207
"Lincoln County","Lincoln County, Nebraska","6640665043","28802238   ","050","00","2","4","31111","31","111",34632,34229,403,158,245
"Logan County","Logan County, Nebraska","1478057458","1204095    ","050","00","2","4","31113","31","113",774,772,2,2,0
"Loup County","Loup County, Nebraska","1475539038","3387965    ","050","00","2","4","31115","31","115",712,705,7,6,1
"McPherson County","McPherson County, Nebraska","2224752851","2680677    ","050","00","2","4","31117","31","117",533,533,0,0,0
"Madison County","Madison County, Nebraska","1482939276","6438424    ","050","00","2","4","31119","31","119",35226,33291,1935,503,1432
"Merrick County","Merrick County, Nebraska","1255825790","25504022   ","050","00","2","4","31121","31","121",8204,8125,79,32,47
"Morrill County","Morrill County, Nebraska","3687496634","15698177   ","050","00","2","4","31123","31","123",5440,5235,205,118,87
"Nance County","Nance County, Nebraska","1143006230","17424702   ","050","00","2","4","31125","31","125",4038,4006,32,20,12
"Nemaha County","Nemaha County, Nebraska","1060093894","6689781    ","050","00","2","4","31127","31","127",7576,7517,59,39,20
"Nuckolls County","Nuckolls County, Nebraska","1490024213","1711553    ","050","00","2","4","31129","31","129",5057,5025,32,9,23
"Otoe County","Otoe County, Nebraska","1594622529","8812924    ","050","00","2","4","31131","31","131",15396,15188,208,93,115
"Pawnee County","Pawnee County, Nebraska","1117766357","3568564    ","050","00","2","4","31133","31","133",3087,3076,11,0,11
"Perkins County","Perkins County, Nebraska","2287415634","2840160    ","050","00","2","4","31135","31","135",3200,3156,44,20,24
"Phelps County","Phelps County, Nebraska","1398508393","1646734    ","050","00","2","4","31137","31","137",9747,9665,82,58,24
"Pierce County","Pierce County, Nebraska","1486463005","3473344    ","050","00","2","4","31139","31","139",7857,7798,59,33,26
"Platte County","Platte County, Nebraska","1756189900","28517020   ","050","00","2","4","31141","31","141",31662,30374,1288,363,925
"Polk County","Polk County, Nebraska","1136579500","4868868    ","050","00","2","4","31143","31","143",5639,5593,46,18,28
"Red Willow County","Red Willow County, Nebraska","1856125543","3638455    ","050","00","2","4","31145","31","145",11448,11314,134,59,75
"Richardson County","Richardson County, Nebraska","1432933919","6981194    ","050","00","2","4","31147","31","147",9531,9413,118,65,53
"Rock County","Rock County, Nebraska","2611893491","8794649    ","050","00","2","4","31149","31","149",1756,1751,5,2,3
"Saline County","Saline County, Nebraska","1490116520","1878878    ","050","00","2","4","31151","31","151",13843,13009,834,139,695
"Sarpy County","Sarpy County, Nebraska","622940492","17506001   ","050","00","2","4","31153","31","153",122595,118100,4495,2434,2061
"Saunders County","Saunders County, Nebraska","1952579413","12747377   ","050","00","2","4","31155","31","155",19830,19593,237,104,133
"Scotts Bluff County","Scotts Bluff County, Nebraska","1914710656","16115803   ","050","00","2","4","31157","31","157",36951,35447,1504,666,838
"Seward County","Seward County, Nebraska","1488604466","2522690    ","050","00","2","4","31159","31","159",16496,16214,282,117,165
"Sheridan County","Sheridan County, Nebraska","6322260408","74990955   ","050","00","2","4","31161","31","161",6198,6153,45,39,6
"Sherman County","Sherman County, Nebraska","1465525181","14978795   ","050","00","2","4","31163","31","163",3318,3304,14,8,6
"Sioux County","Sioux County, Nebraska","5352440055","1885367    ","050","00","2","4","31165","31","165",1475,1456,19,6,13
"Stanton County","Stanton County, Nebraska","1113246136","3190848    ","050","00","2","4","31167","31","167",6455,6380,75,16,59
"Thayer County","Thayer County, Nebraska","1488086985","1939824    ","050","00","2","4","31169","31","169",6055,6004,51,19,32
"Thomas County","Thomas County, Nebraska","1846307604","2044936    ","050","00","2","4","31171","31","171",729,717,12,12,0
"Thurston County","Thurston County, Nebraska","1019967137","6316758    ","050","00","2","4","31173","31","173",7171,7057,114,42,72
"Valley County","Valley County, Nebraska","1471393460","6230264    ","050","00","2","4","31175","31","175",4647,4597,50,25,25
"Washington County","Washington County, Nebraska","1011357253","8473136    ","050","00","2","4","31177","31","177",18780,18471,309,158,151
"Wayne County","Wayne County, Nebraska","1148490238","120548     ","050","00","2","4","31179","31","179",9851,9688,163,27,136
"Webster County","Webster County, Nebraska","1488959463","333721     ","050","00","2","4","31181","31","181",4061,4007,54,29,25
"Wheeler County","Wheeler County, Nebraska","1489672781","1059463    ","050","00","2","4","31183","31","183",886,886,0,0,0
"York County","York County, Nebraska","1490943927","930276     ","050","00","2","4","31185","31","185",14598,14351,247,76,171
"Churchill County","Churchill County, Nevada","12766255433","244231084  ","050","00","4","8","32001","32","001",23982,22545,1437,705,732
"Clark County","Clark County, Nevada","20487673594","467026617  ","050","00","4","8","32003","32","003",1375765,1128014,247751,90437,157314
"Douglas County","Douglas County, Nevada","1838503421","72004140   ","050","00","4","8","32005","32","005",41259,38900,2359,1173,1186
"Elko County","Elko County, Nevada","44493479182","61918274   ","050","00","4","8","32007","32","007",45291,40655,4636,1538,3098
"Esmeralda County","Esmeralda County, Nevada","9294172662","1285047    ","050","00","4","8","32009","32","009",971,908,63,27,36
"Eureka County","Eureka County, Nevada","10814954673","11082841   ","050","00","4","8","32011","32","011",1651,1523,128,30,98
"Humboldt County","Humboldt County, Nevada","24987980609","25797606   ","050","00","4","8","32013","32","013",16106,14437,1669,738,931
"Lander County","Lander County, Nevada","14228439296","66925931   ","050","00","4","8","32015","32","015",5794,5240,554,237,317
"Lincoln County","Lincoln County, Nevada","27540913255","8198823    ","050","00","4","8","32017","32","017",4165,4020,145,47,98
"Lyon County","Lyon County, Nevada","5163627269","58812123   ","050","00","4","8","32019","32","019",34501,32414,2087,997,1090
"Mineral County","Mineral County, Nevada","9729043485","146502586  ","050","00","4","8","32021","32","021",5071,4947,124,73,51
"Nye County","Nye County, Nevada","46999636520","31249657   ","050","00","4","8","32023","32","023",32485,30856,1629,741,888
"Pershing County","Pershing County, Nevada","15634612520","80260853   ","050","00","4","8","32027","32","027",6693,6223,470,186,284
"Storey County","Storey County, Nevada","682338873","890498     ","050","00","4","8","32029","32","029",3399,3325,74,46,28
"Washoe County","Washoe County, Nevada","16426407878","541430135  ","050","00","4","8","32031","32","031",339486,291493,47993,18007,29986
"White Pine County","White Pine County, Nevada","22988684086","53411374   ","050","00","4","8","32033","32","033",9181,8912,269,149,120
"Carson City","Carson City, Nevada","371286092","31871712   ","050","00","4","8","32510","32","510",52457,47252,5205,1655,3550
"Belknap County","Belknap County, New Hampshire","1039344300","174204374  ","050","00","1","1","33001","33","001",56325,54903,1422,778,644
"Carroll County","Carroll County, New Hampshire","2418526952","151350772  ","050","00","1","1","33003","33","003",43666,42623,1043,643,400
"Cheshire County","Cheshire County, New Hampshire","1832146309","56330923   ","050","00","1","1","33005","33","005",73825,72180,1645,949,696
"Coos County","Coos County, New Hampshire","4662978515","80433674   ","050","00","1","1","33007","33","007",33111,31789,1322,841,481
"Grafton County","Grafton County, New Hampshire","4437509185","95176279   ","050","00","1","1","33009","33","009",81743,78552,3191,1527,1664
"Hillsborough County","Hillsborough County, New Hampshire","2269764589","41021469   ","050","00","1","1","33011","33","011",380841,355048,25793,10465,15328
"Merrimack County","Merrimack County, New Hampshire","2420162999","57136156   ","050","00","1","1","33013","33","013",136225,131874,4351,2258,2093
"Rockingham County","Rockingham County, New Hampshire","1799950065","256409214  ","050","00","1","1","33015","33","015",277359,266969,10390,5849,4541
"Strafford County","Strafford County, New Hampshire","955086700","39247782   ","050","00","1","1","33017","33","017",112233,108420,3813,1831,1982
"Sullivan County","Sullivan County, New Hampshire","1391796133","37659407   ","050","00","1","1","33019","33","019",40458,39274,1184,620,564
"Atlantic County","Atlantic County, New Jersey","1453175705","285861629  ","050","00","1","2","34001","34","001",252552,222757,29795,12826,16969
"Bergen County","Bergen County, New Jersey","606500068","32700752   ","050","00","1","2","34003","34","003",884118,661817,222301,112882,109419
"Burlington County","Burlington County, New Jersey","2083834265","38476657   ","050","00","1","2","34005","34","005",423394,396713,26681,15591,11090
"Camden County","Camden County, New Jersey","575748971","13680780   ","050","00","1","2","34007","34","007",508932,473582,35350,18694,16656
"Cape May County","Cape May County, New Jersey","660927764","945588957  ","050","00","1","2","34009","34","009",102326,99038,3288,2020,1268
"Cumberland County","Cumberland County, New Jersey","1267273415","485091741  ","050","00","1","2","34011","34","011",146438,137431,9007,3514,5493
"Essex County","Essex County, New Jersey","327029640","8528767    ","050","00","1","2","34013","34","013",793633,625468,168165,73983,94182
"Gloucester County","Gloucester County, New Jersey","841016405","31601580   ","050","00","1","2","34015","34","015",254673,246107,8566,5321,3245
"Hudson County","Hudson County, New Jersey","120920280","40778898   ","050","00","1","2","34017","34","017",608975,374378,234597,97376,137221
"Hunterdon County","Hunterdon County, New Jersey","1113545868","20244411   ","050","00","1","2","34019","34","019",121989,114281,7708,4374,3334
"Mercer County","Mercer County, New Jersey","585153425","7528582    ","050","00","1","2","34021","34","021",350761,302102,48659,20225,28434
"Middlesex County","Middlesex County, New Jersey","802169805","33131870   ","050","00","1","2","34023","34","023",750162,568401,181761,77921,103840
"Monmouth County","Monmouth County, New Jersey","1222313221","500334433  ","050","00","1","2","34025","34","025",615301,551494,63807,34090,29717
"Morris County","Morris County, New Jersey","1214684587","31841090   ","050","00","1","2","34027","34","027",470212,397574,72638,36134,36504
"Ocean County","Ocean County, New Jersey","1647947493","724166491  ","050","00","1","2","34029","34","029",510916,477764,33152,20293,12859
"Passaic County","Passaic County, New Jersey","479903640","30457274   ","050","00","1","2","34031","34","031",489049,358758,130291,53888,76403
"Salem County","Salem County, New Jersey","875105142","89848883   ","050","00","1","2","34033","34","033",64285,62665,1620,890,730
"Somerset County","Somerset County, New Jersey","789134743","942362     ","050","00","1","2","34035","34","035",297490,243553,53937,25253,28684
"Sussex County","Sussex County, New Jersey","1350045452","38162354   ","050","00","1","2","34037","34","037",144166,135995,8171,5191,2980
"Union County","Union County, New Jersey","267517696","5624852    ","050","00","1","2","34039","34","039",522541,391625,130916,58826,72090
"Warren County","Warren County, New Jersey","926870216","12658015   ","050","00","1","2","34041","34","041",102437,96520,5917,3012,2905
"Bernalillo County","Bernalillo County, New Mexico","3020015825","6776278    ","050","00","4","8","35001","35","001",556678,508605,48073,17332,30741
"Catron County","Catron County, New Mexico","17942940225","3166828    ","050","00","4","8","35003","35","003",3543,3487,56,25,31
"Chaves County","Chaves County, New Mexico","15723458875","10899208   ","050","00","4","8","35005","35","005",61382,54491,6891,2350,4541
"Cibola County","Cibola County, New Mexico","11756510105","6474885    ","050","00","4","8","35006","35","006",25595,25012,583,331,252
"Colfax County","Colfax County, New Mexico","9730046562","29150621   ","050","00","4","8","35007","35","007",14189,13872,317,130,187
"Curry County","Curry County, New Mexico","3641392209","4450841    ","050","00","4","8","35009","35","009",45044,42400,2644,1003,1641
"De Baca County","De Baca County, New Mexico","6021387600","23215618   ","050","00","4","8","35011","35","011",2240,2157,83,46,37
"Dona Ana County","Dona Ana County, New Mexico","9860559833","19259154   ","050","00","4","8","35013","35","013",174682,142059,32623,11233,21390
"Eddy County","Eddy County, New Mexico","10831385925","40281198   ","050","00","4","8","35015","35","015",51658,48915,2743,1315,1428
"Grant County","Grant County, New Mexico","10271585524","4201280    ","050","00","4","8","35017","35","017",31002,29967,1035,629,406
"Guadalupe County","Guadalupe County, New Mexico","7848628789","3115444    ","050","00","4","8","35019","35","019",4680,4493,187,60,127
"Harding County","Harding County, New Mexico","5504611815","1578018    ","050","00","4","8","35021","35","021",810,790,20,6,14
"Hidalgo County","Hidalgo County, New Mexico","8924148744","722985     ","050","00","4","8","35023","35","023",5932,5275,657,244,413
"Lea County","Lea County, New Mexico","11377705796","2750135    ","050","00","4","8","35025","35","025",55511,49246,6265,2183,4082
"Lincoln County","Lincoln County, New Mexico","12512149241","735685     ","050","00","4","8","35027","35","027",19411,18222,1189,446,743
"Los Alamos County","Los Alamos County, New Mexico","283202780","0          ","050","00","4","8","35028","35","028",18343,17111,1232,567,665
"Luna County","Luna County, New Mexico","7679544556","488373     ","050","00","4","8","35029","35","029",25016,20132,4884,1216,3668
"McKinley County","McKinley County, New Mexico","14112121031","16821173   ","050","00","4","8","35031","35","031",74798,73459,1339,598,741
"Mora County","Mora County, New Mexico","5001516792","6163875    ","050","00","4","8","35033","35","033",5180,5093,87,73,14
"Otero County","Otero County, New Mexico","17162558057","2401912    ","050","00","4","8","35035","35","035",62298,55359,6939,2105,4834
"Quay County","Quay County, New Mexico","7446024141","17797623   ","050","00","4","8","35037","35","037",10155,9810,345,112,233
"Rio Arriba County","Rio Arriba County, New Mexico","15171195655","99641340   ","050","00","4","8","35039","35","039",41190,39648,1542,292,1250
"Roosevelt County","Roosevelt County, New Mexico","6341572862","16510637   ","050","00","4","8","35041","35","041",18018,16904,1114,545,569
"Sandoval County","Sandoval County, New Mexico","9607140524","12910224   ","050","00","4","8","35043","35","043",89908,86028,3880,1985,1895
"San Juan County","San Juan County, New Mexico","14281238377","63053856   ","050","00","4","8","35045","35","045",113801,111055,2746,908,1838
"San Miguel County","San Miguel County, New Mexico","12217077804","48148642   ","050","00","4","8","35047","35","047",30126,29381,745,174,571
"Santa Fe County","Santa Fe County, New Mexico","4944779399","4137562    ","050","00","4","8","35049","35","049",129292,116217,13075,3587,9488
"Sierra County","Sierra County, New Mexico","10826751302","145222307  ","050","00","4","8","35051","35","051",13270,12398,872,282,590
"Socorro County","Socorro County, New Mexico","17214096966","5990376    ","050","00","4","8","35053","35","053",18078,16913,1165,289,876
"Taos County","Taos County, New Mexico","5706182287","3760596    ","050","00","4","8","35055","35","055",29979,28736,1243,417,826
"Torrance County","Torrance County, New Mexico","8663019678","2577817    ","050","00","4","8","35057","35","057",16911,16196,715,262,453
"Union County","Union County, New Mexico","9919664950","2039238    ","050","00","4","8","35059","35","059",4174,4084,90,34,56
"Valencia County","Valencia County, New Mexico","2765141765","1503770    ","050","00","4","8","35061","35","061",66152,61925,4227,1324,2903
"Albany County","Albany County, New York","1355717543","25287562   ","050","00","1","2","36001","36","001",294565,275337,19228,11141,8087
"Allegany County","Allegany County, New York","2668256500","10879826   ","050","00","1","2","36003","36","003",49927,49007,920,395,525
"Bronx County","Bronx County, New York","108849557","39881826   ","050","00","1","2","36005","36","005",1332650,946823,385827,152521,233306
"Broome County","Broome County, New York","1830662628","22382347   ","050","00","1","2","36007","36","007",200536,190000,10536,5834,4702
"Cattaraugus County","Cattaraugus County, New York","3392501766","32111026   ","050","00","1","2","36009","36","009",83955,82772,1183,678,505
"Cayuga County","Cayuga County, New York","1795340503","441482145  ","050","00","1","2","36011","36","011",81963,80107,1856,1039,817
"Chautauqua County","Chautauqua County, New York","2750690434","1134334835 ","050","00","1","2","36013","36","013",139750,137107,2643,1665,978
"Chemung County","Chemung County, New York","1057155027","6777388    ","050","00","1","2","36015","36","015",91070,89098,1972,938,1034
"Chenango County","Chenango County, New York","2316375292","11249944   ","050","00","1","2","36017","36","017",51401,50514,887,591,296
"Clinton County","Clinton County, New York","2690866698","203741880  ","050","00","1","2","36019","36","019",79894,76266,3628,1578,2050
"Columbia County","Columbia County, New York","1646543485","32474484   ","050","00","1","2","36021","36","021",63094,60315,2779,1615,1164
"Cortland County","Cortland County, New York","1294091473","4844407    ","050","00","1","2","36023","36","023",48599,47518,1081,663,418
"Delaware County","Delaware County, New York","3746087750","56124260   ","050","00","1","2","36025","36","025",48055,46407,1648,1111,537
"Dutchess County","Dutchess County, New York","2076120617","61593139   ","050","00","1","2","36027","36","027",280150,256550,23600,11282,12318
"Erie County","Erie County, New York","2704492010","473144792  ","050","00","1","2","36029","36","029",950265,907379,42886,25043,17843
"Essex County","Essex County, New York","4653693874","310021093  ","050","00","1","2","36031","36","031",38851,37541,1310,607,703
"Franklin County","Franklin County, New York","4225532125","170814000  ","050","00","1","2","36033","36","033",51134,49229,1905,797,1108
"Fulton County","Fulton County, New York","1285064700","95136086   ","050","00","1","2","36035","36","035",55073,54003,1070,738,332
"Genesee County","Genesee County, New York","1279736563","3171483    ","050","00","1","2","36037","36","037",60370,59065,1305,650,655
"Greene County","Greene County, New York","1677654401","26894458   ","050","00","1","2","36039","36","039",48195,45131,3064,2035,1029
"Hamilton County","Hamilton County, New York","4455798107","226402461  ","050","00","1","2","36041","36","041",5379,5297,82,66,16
"Herkimer County","Herkimer County, New York","3655120284","121994888  ","050","00","1","2","36043","36","043",64427,63130,1297,938,359
"Jefferson County","Jefferson County, New York","3294987287","1514822790 ","050","00","1","2","36045","36","045",111738,107622,4116,1872,2244
"Kings County","Kings County, New York","182868822","68098529   ","050","00","1","2","36047","36","047",2465326,1533557,931769,439973,491796
"Lewis County","Lewis County, New York","3303331225","37470642   ","050","00","1","2","36049","36","049",26944,26639,305,183,122
"Livingston County","Livingston County, New York","1637203909","21537546   ","050","00","1","2","36051","36","051",64328,62660,1668,967,701
"Madison County","Madison County, New York","1698658960","14727544   ","050","00","1","2","36053","36","053",69441,67883,1558,880,678
"Monroe County","Monroe County, New York","1707563493","1829338448 ","050","00","1","2","36055","36","055",735343,681600,53743,29655,24088
"Montgomery County","Montgomery County, New York","1048466937","14268015   ","050","00","1","2","36057","36","057",49708,48134,1574,1157,417
"Nassau County","Nassau County, New York","742529382","430951276  ","050","00","1","2","36059","36","059",1334544,1096130,238414,132767,105647
"New York County","New York County, New York","59475834","27988473   ","050","00","1","2","36061","36","061",1537195,1084755,452440,179785,272655
"Niagara County","Niagara County, New York","1354428146","1597726259 ","050","00","1","2","36063","36","063",219846,211351,8495,5212,3283
"Oneida County","Oneida County, New York","3140885727","115024072  ","050","00","1","2","36065","36","065",235469,223122,12347,4861,7486
"Onondaga County","Onondaga County, New York","2020950659","65785744   ","050","00","1","2","36067","36","067",458336,432407,25929,13498,12431
"Ontario County","Ontario County, New York","1668941972","46740560   ","050","00","1","2","36069","36","069",100224,97475,2749,1575,1174
"Orange County","Orange County, New York","2114304694","57518822   ","050","00","1","2","36071","36","071",341367,312657,28710,13889,14821
"Orleans County","Orleans County, New York","1013709684","1103526251 ","050","00","1","2","36073","36","073",44171,42999,1172,377,795
"Oswego County","Oswego County, New York","2469040630","929487493  ","050","00","1","2","36075","36","075",122377,120419,1958,1181,777
"Otsego County","Otsego County, New York","2597227248","31876654   ","050","00","1","2","36077","36","077",61676,60260,1416,993,423
"Putnam County","Putnam County, New York","599019960","38768295   ","050","00","1","2","36079","36","079",95745,87325,8420,4356,4064
"Queens County","Queens County, New York","282917871","178822272  ","050","00","1","2","36081","36","081",2229379,1201040,1028339,466608,561731
"Rensselaer County","Rensselaer County, New York","1693759484","29592349   ","050","00","1","2","36083","36","083",152538,146829,5709,2963,2746
"Richmond County","Richmond County, New York","151459071","114017242  ","050","00","1","2","36085","36","085",443728,371071,72657,39800,32857
"Rockland County","Rockland County, New York","451223919","65067358   ","050","00","1","2","36087","36","087",286753,231987,54766,27846,26920
"St. Lawrence County","St. Lawrence County, New York","6955664075","351933679  ","050","00","1","2","36089","36","089",111931,108131,3800,1908,1892
"Saratoga County","Saratoga County, New York","2102666741","82540455   ","050","00","1","2","36091","36","091",200635,194447,6188,3881,2307
"Schenectady County","Schenectady County, New York","533803732","9115311    ","050","00","1","2","36093","36","093",146555,138744,7811,4932,2879
"Schoharie County","Schoharie County, New York","1611029328","11227794   ","050","00","1","2","36095","36","095",31582,30833,749,511,238
"Schuyler County","Schuyler County, New York","851348245","34986337   ","050","00","1","2","36097","36","097",19224,18994,230,145,85
"Seneca County","Seneca County, New York","841520646","169905350  ","050","00","1","2","36099","36","099",33342,32526,816,472,344
"Steuben County","Steuben County, New York","3606927293","29665604   ","050","00","1","2","36101","36","101",98726,96881,1845,1084,761
"Suffolk County","Suffolk County, New York","2362581959","3783634115 ","050","00","1","2","36103","36","103",1419369,1260844,158525,77416,81109
"Sullivan County","Sullivan County, New York","2511549213","70292060   ","050","00","1","2","36105","36","105",73966,68091,5875,3038,2837
"Tioga County","Tioga County, New York","1343406328","10914709   ","050","00","1","2","36107","36","107",51784,50912,872,558,314
"Tompkins County","Tompkins County, New York","1232966623","40336511   ","050","00","1","2","36109","36","109",96501,86335,10166,2874,7292
"Ulster County","Ulster County, New York","2917562516","88793051   ","050","00","1","2","36111","36","111",177749,167281,10468,5482,4986
"Warren County","Warren County, New York","2251455113","161535879  ","050","00","1","2","36113","36","113",63303,61762,1541,996,545
"Washington County","Washington County, New York","2163773821","26940706   ","050","00","1","2","36115","36","115",61042,59889,1153,553,600
"Wayne County","Wayne County, New York","1564905741","2020005023 ","050","00","1","2","36117","36","117",93765,91608,2157,1388,769
"Westchester County","Westchester County, New York","1121010057","174202122  ","050","00","1","2","36119","36","119",923459,718030,205429,85546,119883
"Wyoming County","Wyoming County, New York","1535640563","9131855    ","050","00","1","2","36121","36","121",43424,42442,982,371,611
"Yates County","Yates County, New York","876027531","97188355   ","050","00","1","2","36123","36","123",24621,24056,565,266,299
"Alamance County","Alamance County, North Carolina","1113666933","12387821   ","050","00","3","5","37001","37","001",130800,122519,8281,1530,6751
"Alexander County","Alexander County, North Carolina","673874959","7644765    ","050","00","3","5","37003","37","003",33603,32790,813,245,568
"Alleghany County","Alleghany County, North Carolina","607739796","2243327    ","050","00","3","5","37005","37","005",10677,10236,441,106,335
"Anson County","Anson County, North Carolina","1376752024","14400637   ","050","00","3","5","37007","37","007",25275,25096,179,40,139
"Ashe County","Ashe County, North Carolina","1103670000","1694046    ","050","00","3","5","37009","37","009",24384,23917,467,121,346
"Avery County","Avery County, North Carolina","639738401","527045     ","050","00","3","5","37011","37","011",17167,16729,438,115,323
"Beaufort County","Beaufort County, North Carolina","2144423727","338571604  ","050","00","3","5","37013","37","013",44958,43768,1190,414,776
"Bertie County","Bertie County, North Carolina","1810902223","108850688  ","050","00","3","5","37015","37","015",19773,19641,132,56,76
"Bladen County","Bladen County, North Carolina","2266074319","31575573   ","050","00","3","5","37017","37","017",32278,31541,737,194,543
"Brunswick County","Brunswick County, North Carolina","2213905679","505602025  ","050","00","3","5","37019","37","019",73143,71052,2091,744,1347
"Buncombe County","Buncombe County, North Carolina","1699005718","9868555    ","050","00","3","5","37021","37","021",206330,198366,7964,2672,5292
"Burke County","Burke County, North Carolina","1312410425","21150938   ","050","00","3","5","37023","37","023",89148,84856,4292,1131,3161
"Cabarrus County","Cabarrus County, North Carolina","943764965","1532555    ","050","00","3","5","37025","37","025",131063,124943,6120,1304,4816
"Caldwell County","Caldwell County, North Carolina","1221436131","6981863    ","050","00","3","5","37027","37","027",77415,75906,1509,351,1158
"Camden County","Camden County, North Carolina","623351204","168406928  ","050","00","3","5","37029","37","029",6885,6840,45,10,35
"Carteret County","Carteret County, North Carolina","1346382998","2125563233 ","050","00","3","5","37031","37","031",59383,58184,1199,553,646
"Caswell County","Caswell County, North Carolina","1099879489","9737694    ","050","00","3","5","37033","37","033",23501,23123,378,113,265
"Catawba County","Catawba County, North Carolina","1035911179","35072900   ","050","00","3","5","37035","37","035",141685,132518,9167,1910,7257
"Chatham County","Chatham County, North Carolina","1768580350","67841557   ","050","00","3","5","37037","37","037",49329,45020,4309,634,3675
"Cherokee County","Cherokee County, North Carolina","1178932471","29753530   ","050","00","3","5","37039","37","039",24298,23998,300,132,168
"Chowan County","Chowan County, North Carolina","447127722","157142611  ","050","00","3","5","37041","37","041",14526,14393,133,46,87
"Clay County","Clay County, North Carolina","556076438","15267676   ","050","00","3","5","37043","37","043",8775,8671,104,71,33
"Cleveland County","Cleveland County, North Carolina","1203384562","10273196   ","050","00","3","5","37045","37","045",96287,94630,1657,507,1150
"Columbus County","Columbus County, North Carolina","2426310950","43500988   ","050","00","3","5","37047","37","047",54749,53959,790,237,553
"Craven County","Craven County, North Carolina","1834817138","170201927  ","050","00","3","5","37049","37","049",91436,88349,3087,1226,1861
"Cumberland County","Cumberland County, North Carolina","1690527787","14867046   ","050","00","3","5","37051","37","051",302963,287038,15925,8185,7740
"Currituck County","Currituck County, North Carolina","677789254","683636764  ","050","00","3","5","37053","37","053",18190,17936,254,119,135
"Dare County","Dare County, North Carolina","993460639","3050832970 ","050","00","3","5","37055","37","055",29967,29216,751,323,428
"Davidson County","Davidson County, North Carolina","1430059233","37861540   ","050","00","3","5","37057","37","057",147246,141998,5248,1061,4187
"Davie County","Davie County, North Carolina","686825165","4408857    ","050","00","3","5","37059","37","059",34835,33648,1187,323,864
"Duplin County","Duplin County, North Carolina","2117904936","3579760    ","050","00","3","5","37061","37","061",49063,43542,5521,632,4889
"Durham County","Durham County, North Carolina","751918788","19359145   ","050","00","3","5","37063","37","063",223314,199061,24253,4592,19661
"Edgecombe County","Edgecombe County, North Carolina","1308011201","4024816    ","050","00","3","5","37065","37","065",55606,54455,1151,269,882
"Forsyth County","Forsyth County, North Carolina","1060846418","8606869    ","050","00","3","5","37067","37","067",306067,286231,19836,3942,15894
"Franklin County","Franklin County, North Carolina","1274332932","6644575    ","050","00","3","5","37069","37","069",47260,45568,1692,216,1476
"Gaston County","Gaston County, North Carolina","922591283","18979569   ","050","00","3","5","37071","37","071",190365,184050,6315,1455,4860
"Gates County","Gates County, North Carolina","882169187","12937575   ","050","00","3","5","37073","37","073",10516,10399,117,43,74
"Graham County","Graham County, North Carolina","756451169","24687436   ","050","00","3","5","37075","37","075",7993,7892,101,49,52
"Granville County","Granville County, North Carolina","1375586928","14105549   ","050","00","3","5","37077","37","077",48498,46571,1927,346,1581
"Greene County","Greene County, North Carolina","687379655","1281374    ","050","00","3","5","37079","37","079",18974,18037,937,102,835
"Guilford County","Guilford County, North Carolina","1681997762","21439825   ","050","00","3","5","37081","37","081",421048,393731,27317,6901,20416
"Halifax County","Halifax County, North Carolina","1878666202","15514131   ","050","00","3","5","37083","37","083",57370,56726,644,198,446
"Harnett County","Harnett County, North Carolina","1541075745","16284130   ","050","00","3","5","37085","37","085",91025,86848,4177,1155,3022
"Haywood County","Haywood County, North Carolina","1433982337","2488482    ","050","00","3","5","37087","37","087",54033,53182,851,332,519
"Henderson County","Henderson County, North Carolina","968661402","2683714    ","050","00","3","5","37089","37","089",89173,83878,5295,1801,3494
"Hertford County","Hertford County, North Carolina","914933867","18553158   ","050","00","3","5","37091","37","091",22601,22331,270,111,159
"Hoke County","Hoke County, North Carolina","1013241954","2911818    ","050","00","3","5","37093","37","093",33646,31706,1940,666,1274
"Hyde County","Hyde County, North Carolina","1587132404","2101000128 ","050","00","3","5","37095","37","095",5826,5694,132,83,49
"Iredell County","Iredell County, North Carolina","1490714443","55524616   ","050","00","3","5","37097","37","097",122660,118188,4472,1031,3441
"Jackson County","Jackson County, North Carolina","1270944084","9815969    ","050","00","3","5","37099","37","099",33121,32546,575,209,366
"Johnston County","Johnston County, North Carolina","2050894069","10202355   ","050","00","3","5","37101","37","101",121965,114729,7236,1312,5924
"Jones County","Jones County, North Carolina","1222157794","3735873    ","050","00","3","5","37103","37","103",10381,10161,220,91,129
"Lee County","Lee County, North Carolina","666303731","5356687    ","050","00","3","5","37105","37","105",49040,44367,4673,867,3806
"Lenoir County","Lenoir County, North Carolina","1035612713","5791620    ","050","00","3","5","37107","37","107",59648,58008,1640,494,1146
"Lincoln County","Lincoln County, North Carolina","773865771","21335510   ","050","00","3","5","37109","37","109",63780,60703,3077,590,2487
"McDowell County","McDowell County, North Carolina","1143947086","12259889   ","050","00","3","5","37111","37","111",42151,41004,1147,302,845
"Macon County","Macon County, North Carolina","1337654690","7763042    ","050","00","3","5","37113","37","113",29811,29027,784,340,444
"Madison County","Madison County, North Carolina","1163991860","5613661    ","050","00","3","5","37115","37","115",19635,19311,324,159,165
"Martin County","Martin County, North Carolina","1194436818","822206     ","050","00","3","5","37117","37","117",25593,25210,383,131,252
"Mecklenburg County","Mecklenburg County, North Carolina","1363045973","51653712   ","050","00","3","5","37119","37","119",695454,627105,68349,19810,48539
"Mitchell County","Mitchell County, North Carolina","573493531","1839793    ","050","00","3","5","37121","37","121",15687,15451,236,61,175
"Montgomery County","Montgomery County, North Carolina","1273235951","25992832   ","050","00","3","5","37123","37","123",26822,24669,2153,313,1840
"Moore County","Moore County, North Carolina","1807126526","20558142   ","050","00","3","5","37125","37","125",74769,71653,3116,1023,2093
"Nash County","Nash County, North Carolina","1399289186","6278289    ","050","00","3","5","37127","37","127",87420,84813,2607,726,1881
"New Hanover County","New Hanover County, North Carolina","515236496","334068625  ","050","00","3","5","37129","37","129",160307,155098,5209,2099,3110
"Northampton County","Northampton County, North Carolina","1389473615","36601739   ","050","00","3","5","37131","37","131",22086,21924,162,66,96
"Onslow County","Onslow County, North Carolina","1986049524","367097555  ","050","00","3","5","37133","37","133",150355,144226,6129,2686,3443
"Orange County","Orange County, North Carolina","1035575434","3560056    ","050","00","3","5","37135","37","135",118227,107516,10711,2683,8028
"Pamlico County","Pamlico County, North Carolina","872674994","593847164  ","050","00","3","5","37137","37","137",12934,12702,232,104,128
"Pasquotank County","Pasquotank County, North Carolina","587606607","162034674  ","050","00","3","5","37139","37","139",34897,34103,794,374,420
"Pender County","Pender County, North Carolina","2255033326","160492754  ","050","00","3","5","37141","37","141",41082,39619,1463,471,992
"Perquimans County","Perquimans County, North Carolina","640161744","211753419  ","050","00","3","5","37143","37","143",11368,11288,80,61,19
"Person County","Person County, North Carolina","1016080003","30507842   ","050","00","3","5","37145","37","145",35623,35175,448,127,321
"Pitt County","Pitt County, North Carolina","1687575713","8266188    ","050","00","3","5","37147","37","147",133798,128919,4879,1174,3705
"Polk County","Polk County, North Carolina","616040229","1931058    ","050","00","3","5","37149","37","149",18324,17639,685,296,389
"Randolph County","Randolph County, North Carolina","2039255057","6653493    ","050","00","3","5","37151","37","151",130454,123031,7423,1138,6285
"Richmond County","Richmond County, North Carolina","1227599276","14512152   ","050","00","3","5","37153","37","153",46564,45527,1037,247,790
"Robeson County","Robeson County, North Carolina","2457480708","5668966    ","050","00","3","5","37155","37","155",123339,118137,5202,770,4432
"Rockingham County","Rockingham County, North Carolina","1467060704","15273924   ","050","00","3","5","37157","37","157",91928,89463,2465,426,2039
"Rowan County","Rowan County, North Carolina","1324296450","32492719   ","050","00","3","5","37159","37","159",130340,125468,4872,821,4051
"Rutherford County","Rutherford County, North Carolina","1461055191","4622442    ","050","00","3","5","37161","37","161",62899,62019,880,284,596
"Sampson County","Sampson County, North Carolina","2448695929","5200786    ","050","00","3","5","37163","37","163",60161,55886,4275,789,3486
"Scotland County","Scotland County, North Carolina","826579227","3886657    ","050","00","3","5","37165","37","165",35998,35540,458,218,240
"Stanly County","Stanly County, North Carolina","1023194702","23827343   ","050","00","3","5","37167","37","167",58100,56595,1505,401,1104
"Stokes County","Stokes County, North Carolina","1170254796","10484274   ","050","00","3","5","37169","37","169",44711,44027,684,189,495
"Surry County","Surry County, North Carolina","1389578796","3281063    ","050","00","3","5","37171","37","171",71219,67464,3755,636,3119
"Swain County","Swain County, North Carolina","1367774696","32486509   ","050","00","3","5","37173","37","173",12968,12843,125,59,66
"Transylvania County","Transylvania County, North Carolina","980025986","5609601    ","050","00","3","5","37175","37","175",29334,28662,672,378,294
"Tyrrell County","Tyrrell County, North Carolina","1009868638","544909898  ","050","00","3","5","37177","37","177",4149,3982,167,33,134
"Union County","Union County, North Carolina","1650772063","5754233    ","050","00","3","5","37179","37","179",123677,116630,7047,1533,5514
"Vance County","Vance County, North Carolina","656602984","42235437   ","050","00","3","5","37181","37","181",42954,41495,1459,259,1200
"Wake County","Wake County, North Carolina","2154672822","65609320   ","050","00","3","5","37183","37","183",627846,567244,60602,16362,44240
"Warren County","Warren County, North Carolina","1110333603","39095856   ","050","00","3","5","37185","37","185",19972,19515,457,101,356
"Washington County","Washington County, North Carolina","902518706","196646242  ","050","00","3","5","37187","37","187",13723,13535,188,62,126
"Watauga County","Watauga County, North Carolina","809393450","567236     ","050","00","3","5","37189","37","189",42695,41869,826,231,595
"Wayne County","Wayne County, North Carolina","1431147704","10670131   ","050","00","3","5","37191","37","191",113329,108537,4792,1515,3277
"Wilkes County","Wilkes County, North Carolina","1961101555","7100361    ","050","00","3","5","37193","37","193",65632,63686,1946,360,1586
"Wilson County","Wilson County, North Carolina","961116179","8217766    ","050","00","3","5","37195","37","195",73814,70178,3636,731,2905
"Yadkin County","Yadkin County, North Carolina","869081703","5018706    ","050","00","3","5","37197","37","197",36348,34759,1589,213,1376
"Yancey County","Yancey County, North Carolina","809251547","1691778    ","050","00","3","5","37199","37","199",17774,17284,490,100,390
"Adams County","Adams County, North Dakota","2558684113","2388154    ","050","00","2","4","38001","38","001",2593,2553,40,34,6
"Barnes County","Barnes County, North Dakota","3863348387","55902440   ","050","00","2","4","38003","38","003",11775,11664,111,45,66
"Benson County","Benson County, North Dakota","3575736164","151967781  ","050","00","2","4","38005","38","005",6964,6929,35,13,22
"Billings County","Billings County, North Dakota","2982138140","5165797    ","050","00","2","4","38007","38","007",888,879,9,5,4
"Bottineau County","Bottineau County, North Dakota","4321617291","75518837   ","050","00","2","4","38009","38","009",7149,6998,151,64,87
"Bowman County","Bowman County, North Dakota","3009687265","12813508   ","050","00","2","4","38011","38","011",3242,3230,12,11,1
"Burke County","Burke County, North Dakota","2858127164","66637784   ","050","00","2","4","38013","38","013",2242,2208,34,29,5
"Burleigh County","Burleigh County, North Dakota","4229680404","90521374   ","050","00","2","4","38015","38","015",69416,68390,1026,557,469
"Cass County","Cass County, North Dakota","4571921620","6936749    ","050","00","2","4","38017","38","017",123138,119209,3929,1006,2923
"Cavalier County","Cavalier County, North Dakota","3855089893","56146319   ","050","00","2","4","38019","38","019",4831,4710,121,80,41
"Dickey County","Dickey County, North Dakota","2929276466","27606471   ","050","00","2","4","38021","38","021",5757,5663,94,71,23
"Divide County","Divide County, North Dakota","3262166014","89735358   ","050","00","2","4","38023","38","023",2283,2228,55,28,27
"Dunn County","Dunn County, North Dakota","5204838326","188152045  ","050","00","2","4","38025","38","025",3600,3576,24,17,7
"Eddy County","Eddy County, North Dakota","1631999466","36544144   ","050","00","2","4","38027","38","027",2757,2747,10,8,2
"Emmons County","Emmons County, North Dakota","3910577808","116121420  ","050","00","2","4","38029","38","029",4331,4310,21,16,5
"Foster County","Foster County, North Dakota","1645161743","29826810   ","050","00","2","4","38031","38","031",3759,3703,56,32,24
"Golden Valley County","Golden Valley County, North Dakota","2595140943","970926     ","050","00","2","4","38033","38","033",1924,1914,10,5,5
"Grand Forks County","Grand Forks County, North Dakota","3723901402","5241106    ","050","00","2","4","38035","38","035",66109,64006,2103,704,1399
"Grant County","Grant County, North Dakota","4297986823","16721279   ","050","00","2","4","38037","38","037",2841,2803,38,21,17
"Griggs County","Griggs County, North Dakota","1835009761","19852494   ","050","00","2","4","38039","38","039",2754,2726,28,19,9
"Hettinger County","Hettinger County, North Dakota","2932518654","3758979    ","050","00","2","4","38041","38","041",2715,2711,4,2,2
"Kidder County","Kidder County, North Dakota","3498518492","213475609  ","050","00","2","4","38043","38","043",2753,2729,24,16,8
"LaMoure County","LaMoure County, North Dakota","2971174319","9401515    ","050","00","2","4","38045","38","045",4701,4664,37,28,9
"Logan County","Logan County, North Dakota","2570928524","47736646   ","050","00","2","4","38047","38","047",2308,2294,14,10,4
"McHenry County","McHenry County, North Dakota","4853874147","97424590   ","050","00","2","4","38049","38","049",5987,5928,59,39,20
"McIntosh County","McIntosh County, North Dakota","2525740874","51388141   ","050","00","2","4","38051","38","051",3390,3363,27,18,9
"McKenzie County","McKenzie County, North Dakota","7101792799","307871985  ","050","00","2","4","38053","38","053",5737,5656,81,40,41
"McLean County","McLean County, North Dakota","5464757467","565166327  ","050","00","2","4","38055","38","055",9311,9229,82,53,29
"Mercer County","Mercer County, North Dakota","2707803083","173359813  ","050","00","2","4","38057","38","057",8644,8513,131,87,44
"Morton County","Morton County, North Dakota","4989009949","49231201   ","050","00","2","4","38059","38","059",25303,25077,226,107,119
"Mountrail County","Mountrail County, North Dakota","4723964515","303404862  ","050","00","2","4","38061","38","061",6631,6551,80,58,22
"Nelson County","Nelson County, North Dakota","2542387857","70231038   ","050","00","2","4","38063","38","063",3715,3651,64,43,21
"Oliver County","Oliver County, North Dakota","1873912360","19867996   ","050","00","2","4","38065","38","065",2065,2059,6,6,0
"Pembina County","Pembina County, North Dakota","2897555082","7735587    ","050","00","2","4","38067","38","067",8585,8261,324,221,103
"Pierce County","Pierce County, North Dakota","2636137042","166644091  ","050","00","2","4","38069","38","069",4675,4619,56,37,19
"Ramsey County","Ramsey County, North Dakota","3068736114","300530623  ","050","00","2","4","38071","38","071",12066,11880,186,110,76
"Ransom County","Ransom County, North Dakota","2234504725","3578678    ","050","00","2","4","38073","38","073",5890,5835,55,32,23
"Renville County","Renville County, North Dakota","2265632815","44721451   ","050","00","2","4","38075","38","075",2610,2571,39,27,12
"Richland County","Richland County, North Dakota","3721067608","23368231   ","050","00","2","4","38077","38","077",17998,17807,191,94,97
"Rolette County","Rolette County, North Dakota","2337344616","95516039   ","050","00","2","4","38079","38","079",13674,13496,178,79,99
"Sargent County","Sargent County, North Dakota","2224161390","21589733   ","050","00","2","4","38081","38","081",4366,4346,20,13,7
"Sheridan County","Sheridan County, North Dakota","2516824487","88123148   ","050","00","2","4","38083","38","083",1710,1692,18,18,0
"Sioux County","Sioux County, North Dakota","2833757845","88522205   ","050","00","2","4","38085","38","085",4044,4012,32,21,11
"Slope County","Slope County, North Dakota","3154448913","3322154    ","050","00","2","4","38087","38","087",767,765,2,2,0
"Stark County","Stark County, North Dakota","3465824800","5957955    ","050","00","2","4","38089","38","089",22636,22453,183,68,115
"Steele County","Steele County, North Dakota","1845007373","8106393    ","050","00","2","4","38091","38","091",2258,2251,7,4,3
"Stutsman County","Stutsman County, North Dakota","5753406412","199059744  ","050","00","2","4","38093","38","093",21908,21685,223,116,107
"Towner County","Towner County, North Dakota","2653578321","44041358   ","050","00","2","4","38095","38","095",2876,2854,22,18,4
"Traill County","Traill County, North Dakota","2232278186","1673894    ","050","00","2","4","38097","38","097",8477,8360,117,55,62
"Walsh County","Walsh County, North Dakota","3319697441","32019561   ","050","00","2","4","38099","38","099",12389,12155,234,155,79
"Ward County","Ward County, North Dakota","5213344262","112311278  ","050","00","2","4","38101","38","101",58795,57580,1215,639,576
"Wells County","Wells County, North Dakota","3292593360","50101856   ","050","00","2","4","38103","38","103",5102,5062,40,34,6
"Williams County","Williams County, North Dakota","5362459986","200756586  ","050","00","2","4","38105","38","105",19761,19531,230,141,89
"Adams County","Adams County, Ohio","1512317799","4861811    ","050","00","2","3","39001","39","001",27330,27277,53,18,35
"Allen County","Allen County, Ohio","1047458373","6361068    ","050","00","2","3","39003","39","003",108473,107336,1137,652,485
"Ashland County","Ashland County, Ohio","1099122222","6404452    ","050","00","2","3","39005","39","005",52523,51921,602,375,227
"Ashtabula County","Ashtabula County, Ohio","1819309925","1725002864 ","050","00","2","3","39007","39","007",102728,101109,1619,974,645
"Athens County","Athens County, Ohio","1312495866","4612341    ","050","00","2","3","39009","39","009",62223,60180,2043,399,1644
"Auglaize County","Auglaize County, Ohio","1039240345","1207783    ","050","00","2","3","39011","39","011",46611,46116,495,244,251
"Belmont County","Belmont County, Ohio","1391730663","10461588   ","050","00","2","3","39013","39","013",70226,69541,685,455,230
"Brown County","Brown County, Ohio","1273649365","8954523    ","050","00","2","3","39015","39","015",42285,42101,184,101,83
"Butler County","Butler County, Ohio","1210222805","7591130    ","050","00","2","3","39017","39","017",332807,323660,9147,4374,4773
"Carroll County","Carroll County, Ohio","1022198582","11226074   ","050","00","2","3","39019","39","019",28836,28662,174,114,60
"Champaign County","Champaign County, Ohio","1109965084","2968952    ","050","00","2","3","39021","39","021",38890,38606,284,113,171
"Clark County","Clark County, Ohio","1035626909","9590401    ","050","00","2","3","39023","39","023",144742,143018,1724,1115,609
"Clermont County","Clermont County, Ohio","1170649890","14714135   ","050","00","2","3","39025","39","025",177977,175192,2785,1469,1316
"Clinton County","Clinton County, Ohio","1064172782","3640434    ","050","00","2","3","39027","39","027",40543,40119,424,114,310
"Columbiana County","Columbiana County, Ohio","1379056109","7063084    ","050","00","2","3","39029","39","029",112075,110476,1599,630,969
"Coshocton County","Coshocton County, Ohio","1460933355","9079741    ","050","00","2","3","39031","39","031",36655,36286,369,150,219
"Crawford County","Crawford County, Ohio","1041469969","1856647    ","050","00","2","3","39033","39","033",46966,46711,255,166,89
"Cuyahoga County","Cuyahoga County, Ohio","1187481481","2038501172 ","050","00","2","3","39035","39","035",1393978,1305217,88761,50362,38399
"Darke County","Darke County, Ohio","1553469702","1267498    ","050","00","2","3","39037","39","037",53309,52939,370,176,194
"Defiance County","Defiance County, Ohio","1064895060","7841076    ","050","00","2","3","39039","39","039",39500,38901,599,300,299
"Delaware County","Delaware County, Ohio","1145836755","35132618   ","050","00","2","3","39041","39","041",109989,107117,2872,1418,1454
"Erie County","Erie County, Ohio","660128061","961582540  ","050","00","2","3","39043","39","043",79551,78360,1191,828,363
"Fairfield County","Fairfield County, Ohio","1308230532","9029027    ","050","00","2","3","39045","39","045",122759,121158,1601,1015,586
"Fayette County","Fayette County, Ohio","1053041585","1285958    ","050","00","2","3","39047","39","047",28433,28172,261,113,148
"Franklin County","Franklin County, Ohio","1398253363","8948123    ","050","00","2","3","39049","39","049",1068978,1004491,64487,20851,43636
"Fulton County","Fulton County, Ohio","1053563817","1394487    ","050","00","2","3","39051","39","051",42084,41552,532,340,192
"Gallia County","Gallia County, Ohio","1214127014","6106726    ","050","00","2","3","39053","39","053",31069,30820,249,154,95
"Geauga County","Geauga County, Ohio","1045462752","11994653   ","050","00","2","3","39055","39","055",90895,88342,2553,1723,830
"Greene County","Greene County, Ohio","1074530342","3457736    ","050","00","2","3","39057","39","057",147886,142788,5098,2593,2505
"Guernsey County","Guernsey County, Ohio","1351725701","16547247   ","050","00","2","3","39059","39","059",40792,40347,445,284,161
"Hamilton County","Hamilton County, Ohio","1055069826","14034460   ","050","00","2","3","39061","39","061",845303,816724,28579,12251,16328
"Hancock County","Hancock County, Ohio","1376201924","5805506    ","050","00","2","3","39063","39","063",71295,69839,1456,559,897
"Hardin County","Hardin County, Ohio","1218047002","635209     ","050","00","2","3","39065","39","065",31945,31641,304,163,141
"Harrison County","Harrison County, Ohio","1045128556","18814140   ","050","00","2","3","39067","39","067",15856,15772,84,48,36
"Henry County","Henry County, Ohio","1078737284","8999047    ","050","00","2","3","39069","39","069",29210,28823,387,152,235
"Highland County","Highland County, Ohio","1432988964","11810490   ","050","00","2","3","39071","39","071",40875,40617,258,106,152
"Hocking County","Hocking County, Ohio","1094911224","2208517    ","050","00","2","3","39073","39","073",28241,28058,183,39,144
"Holmes County","Holmes County, Ohio","1095543815","2662237    ","050","00","2","3","39075","39","075",38943,38675,268,167,101
"Huron County","Huron County, Ohio","1276059942","4728435    ","050","00","2","3","39077","39","077",59487,58379,1108,460,648
"Jackson County","Jackson County, Ohio","1088518118","3160265    ","050","00","2","3","39079","39","079",32641,32291,350,165,185
"Jefferson County","Jefferson County, Ohio","1060880028","3278364    ","050","00","2","3","39081","39","081",73894,72966,928,673,255
"Knox County","Knox County, Ohio","1365242700","6240925    ","050","00","2","3","39083","39","083",54500,53940,560,292,268
"Lake County","Lake County, Ohio","591065088","1944184300 ","050","00","2","3","39085","39","085",227511,217765,9746,5365,4381
"Lawrence County","Lawrence County, Ohio","1178335424","6006010    ","050","00","2","3","39087","39","087",62319,61985,334,185,149
"Licking County","Licking County, Ohio","1778039109","4859065    ","050","00","2","3","39089","39","089",145491,143841,1650,808,842
"Logan County","Logan County, Ohio","1187351180","21613049   ","050","00","2","3","39091","39","091",46005,45518,487,230,257
"Lorain County","Lorain County, Ohio","1275569838","1115047238 ","050","00","2","3","39093","39","093",284664,277268,7396,4567,2829
"Lucas County","Lucas County, Ohio","881799074","661532330  ","050","00","2","3","39095","39","095",455054,440572,14482,7621,6861
"Madison County","Madison County, Ohio","1205479004","1913949    ","050","00","2","3","39097","39","097",40213,39768,445,192,253
"Mahoning County","Mahoning County, Ohio","1075483825","21072445   ","050","00","2","3","39099","39","099",257555,251494,6061,4382,1679
"Marion County","Marion County, Ohio","1045946872","786548     ","050","00","2","3","39101","39","101",66217,65482,735,388,347
"Medina County","Medina County, Ohio","1091805363","4053499    ","050","00","2","3","39103","39","103",151095,146545,4550,2997,1553
"Meigs County","Meigs County, Ohio","1112199414","7653198    ","050","00","2","3","39105","39","105",23072,23031,41,13,28
"Mercer County","Mercer County, Ohio","1199851841","25974609   ","050","00","2","3","39107","39","107",40924,40614,310,173,137
"Miami County","Miami County, Ohio","1054232617","5642062    ","050","00","2","3","39109","39","109",98868,97401,1467,715,752
"Monroe County","Monroe County, Ohio","1179847563","4964915    ","050","00","2","3","39111","39","111",15180,15132,48,27,21
"Montgomery County","Montgomery County, Ohio","1195735149","6910116    ","050","00","2","3","39113","39","113",559062,545255,13807,7277,6530
"Morgan County","Morgan County, Ohio","1081743425","10867804   ","050","00","2","3","39115","39","115",14897,14816,81,69,12
"Morrow County","Morrow County, Ohio","1052112998","2935743    ","050","00","2","3","39117","39","117",31628,31481,147,91,56
"Muskingum County","Muskingum County, Ohio","1721372758","20632271   ","050","00","2","3","39119","39","119",84585,83961,624,350,274
"Noble County","Noble County, Ohio","1033405451","14466106   ","050","00","2","3","39121","39","121",14058,13971,87,53,34
"Ottawa County","Ottawa County, Ohio","660325431","855130451  ","050","00","2","3","39123","39","123",40985,40531,454,331,123
"Paulding County","Paulding County, Ohio","1078111563","6830361    ","050","00","2","3","39125","39","125",20293,20174,119,82,37
"Perry County","Perry County, Ohio","1061317388","7292726    ","050","00","2","3","39127","39","127",34078,33886,192,99,93
"Pickaway County","Pickaway County, Ohio","1299942718","12639406   ","050","00","2","3","39129","39","129",52727,52365,362,195,167
"Pike County","Pike County, Ohio","1143444613","6361461    ","050","00","2","3","39131","39","131",27695,27526,169,67,102
"Portage County","Portage County, Ohio","1275283374","38117647   ","050","00","2","3","39133","39","133",152061,149018,3043,1430,1613
"Preble County","Preble County, Ohio","1100239413","3940231    ","050","00","2","3","39135","39","135",42337,42072,265,129,136
"Putnam County","Putnam County, Ohio","1253204949","941357     ","050","00","2","3","39137","39","137",34726,34479,247,164,83
"Richland County","Richland County, Ohio","1286904043","8937838    ","050","00","2","3","39139","39","139",128852,126565,2287,1502,785
"Ross County","Ross County, Ohio","1782985342","11774268   ","050","00","2","3","39141","39","141",73345,72807,538,303,235
"Sandusky County","Sandusky County, Ohio","1059759326","22254968   ","050","00","2","3","39143","39","143",61792,60972,820,494,326
"Scioto County","Scioto County, Ohio","1585763831","9853094    ","050","00","2","3","39145","39","145",79195,78709,486,188,298
"Seneca County","Seneca County, Ohio","1426015186","4612806    ","050","00","2","3","39147","39","147",58683,57959,724,348,376
"Shelby County","Shelby County, Ohio","1060010524","4554664    ","050","00","2","3","39149","39","149",47910,47246,664,255,409
"Stark County","Stark County, Ohio","1492185919","12362336   ","050","00","2","3","39151","39","151",378098,371424,6674,4148,2526
"Summit County","Summit County, Ohio","1068948386","19005659   ","050","00","2","3","39153","39","153",542899,525170,17729,9514,8215
"Trumbull County","Trumbull County, Ohio","1596670952","47242586   ","050","00","2","3","39155","39","155",225116,221027,4089,2852,1237
"Tuscarawas County","Tuscarawas County, Ohio","1470013624","10121859   ","050","00","2","3","39157","39","157",90914,90134,780,416,364
"Union County","Union County, Ohio","1130922131","843490     ","050","00","2","3","39159","39","159",40909,40520,389,192,197
"Van Wert County","Van Wert County, Ohio","1062121043","1035182    ","050","00","2","3","39161","39","161",29659,29462,197,110,87
"Vinton County","Vinton County, Ohio","1072462963","2279268    ","050","00","2","3","39163","39","163",12806,12768,38,36,2
"Warren County","Warren County, Ohio","1035028467","19456400   ","050","00","2","3","39165","39","165",158383,154741,3642,1714,1928
"Washington County","Washington County, Ohio","1645018027","12959172   ","050","00","2","3","39167","39","167",63251,62846,405,222,183
"Wayne County","Wayne County, Ohio","1438365058","2479642    ","050","00","2","3","39169","39","169",111564,109679,1885,756,1129
"Williams County","Williams County, Ohio","1092301225","3400685    ","050","00","2","3","39171","39","171",39188,38787,401,275,126
"Wood County","Wood County, Ohio","1598850927","8345571    ","050","00","2","3","39173","39","173",121065,118140,2925,1186,1739
"Wyandot County","Wyandot County, Ohio","1050532416","5204917    ","050","00","2","3","39175","39","175",22908,22714,194,89,105
"Adair County","Adair County, Oklahoma","1490971120","3524108    ","050","00","3","7","40001","40","001",21038,20739,299,100,199
"Alfalfa County","Alfalfa County, Oklahoma","2244611876","38316603   ","050","00","3","7","40003","40","003",6105,6063,42,17,25
"Atoka County","Atoka County, Oklahoma","2533759422","30327317   ","050","00","3","7","40005","40","005",13879,13835,44,27,17
"Beaver County","Beaver County, Oklahoma","4699163829","8347740    ","050","00","3","7","40007","40","007",5857,5534,323,75,248
"Beckham County","Beckham County, Oklahoma","2335726670","5982096    ","050","00","3","7","40009","40","009",19799,19475,324,87,237
"Blaine County","Blaine County, Oklahoma","2404628588","27061511   ","050","00","3","7","40011","40","011",11976,11561,415,120,295
"Bryan County","Bryan County, Oklahoma","2353772237","89694064   ","050","00","3","7","40013","40","013",36534,36016,518,116,402
"Caddo County","Caddo County, Oklahoma","3310857550","31017330   ","050","00","3","7","40015","40","015",30150,29492,658,154,504
"Canadian County","Canadian County, Oklahoma","2330248661","14124978   ","050","00","3","7","40017","40","017",87697,84856,2841,1474,1367
"Carter County","Carter County, Oklahoma","2133608110","25706177   ","050","00","3","7","40019","40","019",45621,45010,611,275,336
"Cherokee County","Cherokee County, Oklahoma","1945179782","65695666   ","050","00","3","7","40021","40","021",42521,41408,1113,239,874
"Choctaw County","Choctaw County, Oklahoma","2004477642","69282455   ","050","00","3","7","40023","40","023",15342,15267,75,31,44
"Cimarron County","Cimarron County, Oklahoma","4752740202","15874367   ","050","00","3","7","40025","40","025",3148,2823,325,90,235
"Cleveland County","Cleveland County, Oklahoma","1388522594","57571717   ","050","00","3","7","40027","40","027",208016,198810,9206,4255,4951
"Coal County","Coal County, Oklahoma","1342184327","7964014    ","050","00","3","7","40029","40","029",6031,5936,95,40,55
"Comanche County","Comanche County, Oklahoma","2769591210","37494739   ","050","00","3","7","40031","40","031",114996,108805,6191,3586,2605
"Cotton County","Cotton County, Oklahoma","1648886159","13741165   ","050","00","3","7","40033","40","033",6614,6513,101,25,76
"Craig County","Craig County, Oklahoma","1971063698","4358779    ","050","00","3","7","40035","40","035",14950,14875,75,36,39
"Creek County","Creek County, Oklahoma","2474823784","36856941   ","050","00","3","7","40037","40","037",67367,66910,457,219,238
"Custer County","Custer County, Oklahoma","2555056323","40118061   ","050","00","3","7","40039","40","039",26142,25264,878,412,466
"Delaware County","Delaware County, Oklahoma","1918274834","133839471  ","050","00","3","7","40041","40","041",37077,36577,500,186,314
"Dewey County","Dewey County, Oklahoma","2590332736","21056927   ","050","00","3","7","40043","40","043",4743,4681,62,25,37
"Ellis County","Ellis County, Oklahoma","3183454160","6993832    ","050","00","3","7","40045","40","045",4075,4041,34,22,12
"Garfield County","Garfield County, Oklahoma","2741220791","4019989    ","050","00","3","7","40047","40","047",57813,56269,1544,640,904
"Garvin County","Garvin County, Oklahoma","2091381916","15997898   ","050","00","3","7","40049","40","049",27210,26766,444,197,247
"Grady County","Grady County, Oklahoma","2851476745","11233853   ","050","00","3","7","40051","40","051",45516,45015,501,234,267
"Grant County","Grant County, Oklahoma","2591441035","7890549    ","050","00","3","7","40053","40","053",5144,5098,46,13,33
"Greer County","Greer County, Oklahoma","1655929355","11148369   ","050","00","3","7","40055","40","055",6061,5972,89,36,53
"Harmon County","Harmon County, Oklahoma","1392946046","1910976    ","050","00","3","7","40057","40","057",3283,3186,97,56,41
"Harper County","Harper County, Oklahoma","2690988982","5077601    ","050","00","3","7","40059","40","059",3562,3437,125,69,56
"Haskell County","Haskell County, Oklahoma","1494501259","124949526  ","050","00","3","7","40061","40","061",11792,11700,92,44,48
"Hughes County","Hughes County, Oklahoma","2089431196","20473698   ","050","00","3","7","40063","40","063",14154,13996,158,55,103
"Jackson County","Jackson County, Oklahoma","2078921366","3809959    ","050","00","3","7","40065","40","065",28439,27100,1339,569,770
"Jefferson County","Jefferson County, Oklahoma","1965163349","39037772   ","050","00","3","7","40067","40","067",6818,6571,247,70,177
"Johnston County","Johnston County, Oklahoma","1669258609","35691672   ","050","00","3","7","40069","40","069",10513,10427,86,31,55
"Kay County","Kay County, Oklahoma","2379434917","68423852   ","050","00","3","7","40071","40","071",48080,46958,1122,391,731
"Kingfisher County","Kingfisher County, Oklahoma","2338763281","7667036    ","050","00","3","7","40073","40","073",13926,13358,568,160,408
"Kiowa County","Kiowa County, Oklahoma","2627687547","41703266   ","050","00","3","7","40075","40","075",10227,10126,101,33,68
"Latimer County","Latimer County, Oklahoma","1870423742","17996043   ","050","00","3","7","40077","40","077",10692,10549,143,59,84
"Le Flore County","Le Flore County, Oklahoma","4107264845","57502225   ","050","00","3","7","40079","40","079",48109,46891,1218,205,1013
"Lincoln County","Lincoln County, Oklahoma","2480526883","20412234   ","050","00","3","7","40081","40","081",32080,31808,272,177,95
"Logan County","Logan County, Oklahoma","1928127010","11558639   ","050","00","3","7","40083","40","083",33924,33413,511,162,349
"Love County","Love County, Oklahoma","1334835151","42892198   ","050","00","3","7","40085","40","085",8831,8545,286,97,189
"McClain County","McClain County, Oklahoma","1475432046","27099632   ","050","00","3","7","40087","40","087",27740,27032,708,274,434
"McCurtain County","McCurtain County, Oklahoma","4797321599","127084612  ","050","00","3","7","40089","40","089",34402,33799,603,158,445
"McIntosh County","McIntosh County, Oklahoma","1605808518","239514974  ","050","00","3","7","40091","40","091",19456,19365,91,33,58
"Major County","Major County, Oklahoma","2477996521","2863587    ","050","00","3","7","40093","40","093",7545,7389,156,57,99
"Marshall County","Marshall County, Oklahoma","961161105","144626411  ","050","00","3","7","40095","40","095",13184,12524,660,142,518
"Mayes County","Mayes County, Oklahoma","1699396324","70891645   ","050","00","3","7","40097","40","097",38369,37984,385,150,235
"Murray County","Murray County, Oklahoma","1083270395","17266650   ","050","00","3","7","40099","40","099",12623,12267,356,66,290
"Muskogee County","Muskogee County, Oklahoma","2107849416","65114158   ","050","00","3","7","40101","40","101",69451,68225,1226,409,817
"Noble County","Noble County, Oklahoma","1895619130","27286001   ","050","00","3","7","40103","40","103",11411,11289,122,49,73
"Nowata County","Nowata County, Oklahoma","1463213683","41242681   ","050","00","3","7","40105","40","105",10569,10548,21,0,21
"Okfuskee County","Okfuskee County, Oklahoma","1618114625","10759874   ","050","00","3","7","40107","40","107",11814,11616,198,96,102
"Oklahoma County","Oklahoma County, Oklahoma","1836542444","23878647   ","050","00","3","7","40109","40","109",660448,612619,47829,15175,32654
"Okmulgee County","Okmulgee County, Oklahoma","1805151680","13840816   ","050","00","3","7","40111","40","111",39685,39392,293,124,169
"Osage County","Osage County, Oklahoma","5829543510","137258981  ","050","00","3","7","40113","40","113",44437,43994,443,231,212
"Ottawa County","Ottawa County, Oklahoma","1220723689","34733931   ","050","00","3","7","40115","40","115",33194,32634,560,181,379
"Pawnee County","Pawnee County, Oklahoma","1474844067","65865983   ","050","00","3","7","40117","40","117",16612,16505,107,55,52
"Payne County","Payne County, Oklahoma","1777615804","27939849   ","050","00","3","7","40119","40","119",68190,65075,3115,527,2588
"Pittsburg County","Pittsburg County, Oklahoma","3382371018","186234622  ","050","00","3","7","40121","40","121",43953,43478,475,200,275
"Pontotoc County","Pontotoc County, Oklahoma","1863850246","15067795   ","050","00","3","7","40123","40","123",35143,34731,412,126,286
"Pottawatomie County","Pottawatomie County, Oklahoma","2040128658","14414692   ","050","00","3","7","40125","40","125",65521,64806,715,275,440
"Pushmataha County","Pushmataha County, Oklahoma","3619022416","65963602   ","050","00","3","7","40127","40","127",11667,11604,63,34,29
"Roger Mills County","Roger Mills County, Oklahoma","2957439603","11867075   ","050","00","3","7","40129","40","129",3436,3412,24,12,12
"Rogers County","Rogers County, Oklahoma","1748104350","94516035   ","050","00","3","7","40131","40","131",70641,69734,907,426,481
"Seminole County","Seminole County, Oklahoma","1638200335","20867412   ","050","00","3","7","40133","40","133",24894,24640,254,100,154
"Sequoyah County","Sequoyah County, Oklahoma","1745174282","106344448  ","050","00","3","7","40135","40","135",38972,38680,292,100,192
"Stephens County","Stephens County, Oklahoma","2263762787","44234130   ","050","00","3","7","40137","40","137",43182,42405,777,343,434
"Texas County","Texas County, Oklahoma","5276215545","30190273   ","050","00","3","7","40139","40","139",20107,16701,3406,882,2524
"Tillman County","Tillman County, Oklahoma","2258379719","18766389   ","050","00","3","7","40141","40","141",9287,8892,395,169,226
"Tulsa County","Tulsa County, Oklahoma","1477070950","43295979   ","050","00","3","7","40143","40","143",563299,533069,30230,9454,20776
"Wagoner County","Wagoner County, Oklahoma","1457940747","72706247   ","050","00","3","7","40145","40","145",57491,56429,1062,523,539
"Washington County","Washington County, Oklahoma","1079548207","19007811   ","050","00","3","7","40147","40","147",48996,48038,958,220,738
"Washita County","Washita County, Oklahoma","2598653727","14830887   ","050","00","3","7","40149","40","149",11508,11325,183,58,125
"Woods County","Woods County, Oklahoma","3332190118","9087177    ","050","00","3","7","40151","40","151",9089,9010,79,37,42
"Woodward County","Woodward County, Oklahoma","3217543391","9612729    ","050","00","3","7","40153","40","153",18486,18020,466,171,295
"Baker County","Baker County, Oregon","7946386250","52618059   ","050","00","4","9","41001","41","001",16741,16437,304,147,157
"Benton County","Benton County, Oregon","1752026651","6499374    ","050","00","4","9","41003","41","003",78153,72194,5959,2111,3848
"Clackamas County","Clackamas County, Oregon","4838545796","28058678   ","050","00","4","9","41005","41","005",338391,314291,24100,9300,14800
"Clatsop County","Clatsop County, Oregon","2142510747","666969991  ","050","00","4","9","41007","41","007",35630,34121,1509,490,1019
"Columbia County","Columbia County, Oregon","1700898190","81877207   ","050","00","4","9","41009","41","009",43560,42780,780,370,410
"Coos County","Coos County, Oregon","4145223617","533280125  ","050","00","4","9","41011","41","011",62779,61111,1668,791,877
"Crook County","Crook County, Oregon","7716562847","20802882   ","050","00","4","9","41013","41","013",19182,18545,637,165,472
"Curry County","Curry County, Oregon","4214902111","935483105  ","050","00","4","9","41015","41","015",21137,20359,778,478,300
"Deschutes County","Deschutes County, Oregon","7816983643","94827280   ","050","00","4","9","41017","41","017",115367,112178,3189,1440,1749
"Douglas County","Douglas County, Oregon","13044797435","251772063  ","050","00","4","9","41019","41","019",100399,98331,2068,1320,748
"Gilliam County","Gilliam County, Oregon","3118521172","48625543   ","050","00","4","9","41021","41","021",1915,1883,32,18,14
"Grant County","Grant County, Oregon","11729029361","1842465    ","050","00","4","9","41023","41","023",7935,7821,114,54,60
"Harney County","Harney County, Oregon","26247791358","238688528  ","050","00","4","9","41025","41","025",7609,7453,156,69,87
"Hood River County","Hood River County, Oregon","1352870112","29033645   ","050","00","4","9","41027","41","027",20411,17056,3355,616,2739
"Jackson County","Jackson County, Oregon","7213617232","42924739   ","050","00","4","9","41029","41","029",181269,172420,8849,3431,5418
"Jefferson County","Jefferson County, Oregon","4612206431","26896560   ","050","00","4","9","41031","41","031",19009,17126,1883,404,1479
"Josephine County","Josephine County, Oregon","4246520510","5288942    ","050","00","4","9","41033","41","033",75726,73380,2346,1356,990
"Klamath County","Klamath County, Oregon","15395370621","496140150  ","050","00","4","9","41035","41","035",63775,60690,3085,1260,1825
"Lake County","Lake County, Oregon","21071502721","576821612  ","050","00","4","9","41037","41","037",7422,7172,250,96,154
"Lane County","Lane County, Oregon","11794816359","434567957  ","050","00","4","9","41039","41","039",322959,306998,15961,6074,9887
"Lincoln County","Lincoln County, Oregon","2537063304","554848746  ","050","00","4","9","41041","41","041",44479,42619,1860,660,1200
"Linn County","Linn County, Oregon","5936706994","46543265   ","050","00","4","9","41043","41","043",103069,99478,3591,1569,2022
"Malheur County","Malheur County, Oregon","25607446448","111112847  ","050","00","4","9","41045","41","045",31615,29016,2599,742,1857
"Marion County","Marion County, Oregon","3066426708","26367183   ","050","00","4","9","41047","41","047",284834,248865,35969,9186,26783
"Morrow County","Morrow County, Oregon","5263840866","41835069   ","050","00","4","9","41049","41","049",10995,9399,1596,273,1323
"Multnomah County","Multnomah County, Oregon","1127244885","78793236   ","050","00","4","9","41051","41","051",660486,576521,83965,28946,55019
"Polk County","Polk County, Oregon","1919247592","8091159    ","050","00","4","9","41053","41","053",62380,58356,4024,1226,2798
"Sherman County","Sherman County, Oregon","2132098424","20708824   ","050","00","4","9","41055","41","055",1934,1886,48,7,41
"Tillamook County","Tillamook County, Oregon","2854544200","597333853  ","050","00","4","9","41057","41","057",24262,23253,1009,343,666
"Umatilla County","Umatilla County, Oregon","8327485562","41422917   ","050","00","4","9","41059","41","059",70548,64618,5930,1594,4336
"Union County","Union County, Oregon","5274651697","5173023    ","050","00","4","9","41061","41","061",24530,23875,655,235,420
"Wallowa County","Wallowa County, Oregon","8146390322","16460646   ","050","00","4","9","41063","41","063",7226,7165,61,31,30
"Wasco County","Wasco County, Oregon","6166883394","36976955   ","050","00","4","9","41065","41","065",23791,22324,1467,545,922
"Washington County","Washington County, Oregon","1874499956","6815184    ","050","00","4","9","41067","41","067",445342,381904,63438,20343,43095
"Wheeler County","Wheeler County, Oregon","4441620931","1412382    ","050","00","4","9","41069","41","069",1547,1515,32,6,26
"Yamhill County","Yamhill County, Oregon","1853303724","7236949    ","050","00","4","9","41071","41","071",84992,78557,6435,1685,4750
"Adams County","Adams County, Pennsylvania","1346813133","3917957    ","050","00","1","2","42001","42","001",91292,88162,3130,1113,2017
"Allegheny County","Allegheny County, Pennsylvania","1891131054","37652307   ","050","00","1","2","42003","42","003",1281666,1233400,48266,23771,24495
"Armstrong County","Armstrong County, Pennsylvania","1693669882","27231081   ","050","00","1","2","42005","42","005",72392,71900,492,348,144
"Beaver County","Beaver County, Pennsylvania","1124606790","25099394   ","050","00","1","2","42007","42","007",181412,178415,2997,2205,792
"Bedford County","Bedford County, Pennsylvania","2627570413","7490988    ","050","00","1","2","42009","42","009",49984,49693,291,170,121
"Berks County","Berks County, Pennsylvania","2224489314","17575375   ","050","00","1","2","42011","42","011",373638,357606,16032,7116,8916
"Blair County","Blair County, Pennsylvania","1361821674","3396553    ","050","00","1","2","42013","42","013",129144,127834,1310,918,392
"Bradford County","Bradford County, Pennsylvania","2980210163","26855936   ","050","00","1","2","42015","42","015",62761,62154,607,433,174
"Bucks County","Bucks County, Pennsylvania","1573098310","38163967   ","050","00","1","2","42017","42","017",597635,562193,35442,20395,15047
"Butler County","Butler County, Pennsylvania","2042292867","16200710   ","050","00","1","2","42019","42","019",174083,171578,2505,1212,1293
"Cambria County","Cambria County, Pennsylvania","1781970761","14002675   ","050","00","1","2","42021","42","021",152598,150663,1935,948,987
"Cameron County","Cameron County, Pennsylvania","1028650727","3717769    ","050","00","1","2","42023","42","023",5974,5940,34,28,6
"Carbon County","Carbon County, Pennsylvania","986881348","16050401   ","050","00","1","2","42025","42","025",58802,57740,1062,755,307
"Centre County","Centre County, Pennsylvania","2868497568","11182795   ","050","00","1","2","42027","42","027",135758,127929,7829,1963,5866
"Chester County","Chester County, Pennsylvania","1957950036","9938873    ","050","00","1","2","42029","42","029",433501,409731,23770,10513,13257
"Clarion County","Clarion County, Pennsylvania","1560311207","16853222   ","050","00","1","2","42031","42","031",41765,41346,419,249,170
"Clearfield County","Clearfield County, Pennsylvania","2971533696","16806894   ","050","00","1","2","42033","42","033",83382,82822,560,349,211
"Clinton County","Clinton County, Pennsylvania","2307330378","18720509   ","050","00","1","2","42035","42","035",37914,37561,353,118,235
"Columbia County","Columbia County, Pennsylvania","1257559112","10983287   ","050","00","1","2","42037","42","037",64151,63238,913,518,395
"Crawford County","Crawford County, Pennsylvania","2622941386","64785446   ","050","00","1","2","42039","42","039",90366,89385,981,645,336
"Cumberland County","Cumberland County, Pennsylvania","1424924264","2530606    ","050","00","1","2","42041","42","041",213674,206751,6923,3619,3304
"Dauphin County","Dauphin County, Pennsylvania","1360493165","83509841   ","050","00","1","2","42043","42","043",251798,241584,10214,4819,5395
"Delaware County","Delaware County, Pennsylvania","477102716","16909016   ","050","00","1","2","42045","42","045",550864,514229,36635,19609,17026
"Elk County","Elk County, Pennsylvania","2146198565","9268669    ","050","00","1","2","42047","42","047",35112,34727,385,266,119
"Erie County","Erie County, Pennsylvania","2077035205","1959210570 ","050","00","1","2","42049","42","049",280843,273137,7706,3632,4074
"Fayette County","Fayette County, Pennsylvania","2046448816","20366796   ","050","00","1","2","42051","42","051",148644,147807,837,515,322
"Forest County","Forest County, Pennsylvania","1108817354","8491468    ","050","00","1","2","42053","42","053",4946,4918,28,18,10
"Franklin County","Franklin County, Pennsylvania","1999252201","1842446    ","050","00","1","2","42055","42","055",129313,126681,2632,1020,1612
"Fulton County","Fulton County, Pennsylvania","1133289763","1201196    ","050","00","1","2","42057","42","057",14261,14164,97,53,44
"Greene County","Greene County, Pennsylvania","1491472030","5407409    ","050","00","1","2","42059","42","059",40672,40402,270,148,122
"Huntingdon County","Huntingdon County, Pennsylvania","2263791320","38792242   ","050","00","1","2","42061","42","061",45586,45245,341,183,158
"Indiana County","Indiana County, Pennsylvania","2147803109","12995841   ","050","00","1","2","42063","42","063",89605,88209,1396,541,855
"Jefferson County","Jefferson County, Pennsylvania","1697684593","3605177    ","050","00","1","2","42065","42","065",45932,45647,285,184,101
"Juniata County","Juniata County, Pennsylvania","1014220756","5124856    ","050","00","1","2","42067","42","067",22821,22587,234,78,156
"Lackawanna County","Lackawanna County, Pennsylvania","1187848196","15221866   ","050","00","1","2","42069","42","069",213295,208462,4833,2907,1926
"Lancaster County","Lancaster County, Pennsylvania","2458056156","89989384   ","050","00","1","2","42071","42","071",470658,455621,15037,7207,7830
"Lawrence County","Lawrence County, Pennsylvania","933588910","5965966    ","050","00","1","2","42073","42","073",94643,93382,1261,889,372
"Lebanon County","Lebanon County, Pennsylvania","937204766","1923619    ","050","00","1","2","42075","42","075",120327,117420,2907,1544,1363
"Lehigh County","Lehigh County, Pennsylvania","897850049","4354647    ","050","00","1","2","42077","42","077",312090,292759,19331,9487,9844
"Luzerne County","Luzerne County, Pennsylvania","2307188467","42256358   ","050","00","1","2","42079","42","079",319250,313079,6171,3731,2440
"Lycoming County","Lycoming County, Pennsylvania","3198255608","23088835   ","050","00","1","2","42081","42","081",120044,118637,1407,829,578
"McKean County","McKean County, Pennsylvania","2542245898","6742360    ","050","00","1","2","42083","42","083",45936,45306,630,305,325
"Mercer County","Mercer County, Pennsylvania","1739995300","27861703   ","050","00","1","2","42085","42","085",120293,118337,1956,1331,625
"Mifflin County","Mifflin County, Pennsylvania","1066705910","7113457    ","050","00","1","2","42087","42","087",46486,46114,372,242,130
"Monroe County","Monroe County, Pennsylvania","1576012246","23100822   ","050","00","1","2","42089","42","089",138687,130621,8066,5052,3014
"Montgomery County","Montgomery County, Pennsylvania","1251271732","11227451   ","050","00","1","2","42091","42","091",750097,697945,52152,27822,24330
"Montour County","Montour County, Pennsylvania","338643301","4009349    ","050","00","1","2","42093","42","093",18236,17830,406,227,179
"Northampton County","Northampton County, Pennsylvania","968130814","9225637    ","050","00","1","2","42095","42","095",267066,254839,12227,6515,5712
"Northumberland County","Northumberland County, Pennsylvania","1191163083","45243823   ","050","00","1","2","42097","42","097",94556,93500,1056,686,370
"Perry County","Perry County, Pennsylvania","1433602230","5825775    ","050","00","1","2","42099","42","099",43602,43197,405,207,198
"Philadelphia County","Philadelphia County, Pennsylvania","349881748","19544394   ","050","00","1","2","42101","42","101",1517550,1380345,137205,64786,72419
"Pike County","Pike County, Pennsylvania","1416227843","51358975   ","050","00","1","2","42103","42","103",46302,44010,2292,1493,799
"Potter County","Potter County, Pennsylvania","2800205016","647072     ","050","00","1","2","42105","42","105",18080,17879,201,127,74
"Schuylkill County","Schuylkill County, Pennsylvania","2015945963","10996017   ","050","00","1","2","42107","42","107",150336,148836,1500,970,530
"Snyder County","Snyder County, Pennsylvania","857815515","2462458    ","050","00","1","2","42109","42","109",37546,37205,341,187,154
"Somerset County","Somerset County, Pennsylvania","2783353467","16861912   ","050","00","1","2","42111","42","111",80023,79442,581,320,261
"Sullivan County","Sullivan County, Pennsylvania","1165327806","6252761    ","050","00","1","2","42113","42","113",6556,6502,54,24,30
"Susquehanna County","Susquehanna County, Pennsylvania","2131204592","24704174   ","050","00","1","2","42115","42","115",42238,41695,543,387,156
"Tioga County","Tioga County, Pennsylvania","2936336196","9269216    ","050","00","1","2","42117","42","117",41373,40937,436,216,220
"Union County","Union County, Pennsylvania","820316944","1009610    ","050","00","1","2","42119","42","119",41624,40087,1537,434,1103
"Venango County","Venango County, Pennsylvania","1748340370","20680429   ","050","00","1","2","42121","42","121",57565,57221,344,223,121
"Warren County","Warren County, Pennsylvania","2288116498","37199979   ","050","00","1","2","42123","42","123",43863,43485,378,262,116
"Washington County","Washington County, Pennsylvania","2219855536","9984749    ","050","00","1","2","42125","42","125",202897,200493,2404,1630,774
"Wayne County","Wayne County, Pennsylvania","1888662719","55223992   ","050","00","1","2","42127","42","127",47722,46275,1447,1046,401
"Westmoreland County","Westmoreland County, Pennsylvania","2655990489","28120950   ","050","00","1","2","42129","42","129",369993,364716,5277,3311,1966
"Wyoming County","Wyoming County, Pennsylvania","1028742898","19665891   ","050","00","1","2","42131","42","131",28080,27737,343,223,120
"York County","York County, Pennsylvania","2342526119","15021372   ","050","00","1","2","42133","42","133",381751,373471,8280,4267,4013
"Bristol County","Bristol County, Rhode Island","63931773","51866941   ","050","00","1","1","44001","44","001",50648,45558,5090,3329,1761
"Kent County","Kent County, Rhode Island","440750358","46425471   ","050","00","1","1","44003","44","003",167090,158983,8107,5260,2847
"Newport County","Newport County, Rhode Island","269480240","542839260  ","050","00","1","1","44005","44","005",85433,81217,4216,2272,1944
"Providence County","Providence County, Rhode Island","1070356682","58423658   ","050","00","1","1","44007","44","007",621602,524926,96676,42285,54391
"Washington County","Washington County, Rhode Island","861829632","595745481  ","050","00","1","1","44009","44","009",123546,118358,5188,3038,2150
"Abbeville County","Abbeville County, South Carolina","1315795989","7816700    ","050","00","3","5","45001","45","001",26167,25899,268,131,137
"Aiken County","Aiken County, South Carolina","2778187147","20184408   ","050","00","3","5","45003","45","003",142552,139300,3252,1411,1841
"Allendale County","Allendale County, South Carolina","1057234221","11342932   ","050","00","3","5","45005","45","005",11211,11051,160,10,150
"Anderson County","Anderson County, South Carolina","1859656873","102128949  ","050","00","3","5","45007","45","007",165740,163224,2516,1100,1416
"Bamberg County","Bamberg County, South Carolina","1018508592","5751364    ","050","00","3","5","45009","45","009",16658,16505,153,87,66
"Barnwell County","Barnwell County, South Carolina","1420387548","22889381   ","050","00","3","5","45011","45","011",23478,23348,130,48,82
"Beaufort County","Beaufort County, South Carolina","1519956088","870303699  ","050","00","3","5","45013","45","013",120937,113341,7596,2332,5264
"Berkeley County","Berkeley County, South Carolina","2843072277","337614128  ","050","00","3","5","45015","45","015",142651,138208,4443,2387,2056
"Calhoun County","Calhoun County, South Carolina","984777734","31367003   ","050","00","3","5","45017","45","017",15185,15038,147,43,104
"Charleston County","Charleston County, South Carolina","2378927011","1138572304 ","050","00","3","5","45019","45","019",309969,298845,11124,4193,6931
"Cherokee County","Cherokee County, South Carolina","1017063949","11891440   ","050","00","3","5","45021","45","021",52537,51830,707,268,439
"Chester County","Chester County, South Carolina","1503529943","14618920   ","050","00","3","5","45023","45","023",34068,33783,285,144,141
"Chesterfield County","Chesterfield County, South Carolina","2068359261","18595231   ","050","00","3","5","45025","45","025",42768,42079,689,161,528
"Clarendon County","Clarendon County, South Carolina","1572655377","229098169  ","050","00","3","5","45027","45","027",32502,32095,407,101,306
"Colleton County","Colleton County, South Carolina","2735949905","199054910  ","050","00","3","5","45029","45","029",38264,37811,453,169,284
"Darlington County","Darlington County, South Carolina","1453358286","14589891   ","050","00","3","5","45031","45","031",67394,66810,584,257,327
"Dillon County","Dillon County, South Carolina","1048535389","4393002    ","050","00","3","5","45033","45","033",30722,30413,309,67,242
"Dorchester County","Dorchester County, South Carolina","1488540267","5068333    ","050","00","3","5","45035","45","035",96413,93723,2690,1379,1311
"Edgefield County","Edgefield County, South Carolina","1299895120","12028424   ","050","00","3","5","45037","45","037",24595,24283,312,154,158
"Fairfield County","Fairfield County, South Carolina","1778265612","60446567   ","050","00","3","5","45039","45","039",23454,23344,110,31,79
"Florence County","Florence County, South Carolina","2071580958","10094839   ","050","00","3","5","45041","45","041",125761,123521,2240,986,1254
"Georgetown County","Georgetown County, South Carolina","2110410005","570216344  ","050","00","3","5","45043","45","043",55797,54586,1211,543,668
"Greenville County","Greenville County, South Carolina","2046301234","12648309   ","050","00","3","5","45045","45","045",379616,361196,18420,5451,12969
"Greenwood County","Greenwood County, South Carolina","1179783609","19221990   ","050","00","3","5","45047","45","047",66271,64429,1842,455,1387
"Hampton County","Hampton County, South Carolina","1449823309","7369890    ","050","00","3","5","45049","45","049",21386,21228,158,63,95
"Horry County","Horry County, South Carolina","2936222646","314111945  ","050","00","3","5","45051","45","051",196629,188823,7806,3250,4556
"Jasper County","Jasper County, South Carolina","1699337533","113108812  ","050","00","3","5","45053","45","053",20678,19554,1124,173,951
"Kershaw County","Kershaw County, South Carolina","1880992934","36257307   ","050","00","3","5","45055","45","055",52647,51778,869,577,292
"Lancaster County","Lancaster County, South Carolina","1421865749","16323981   ","050","00","3","5","45057","45","057",61351,60524,827,239,588
"Laurens County","Laurens County, South Carolina","1852124218","22976621   ","050","00","3","5","45059","45","059",69567,68480,1087,306,781
"Lee County","Lee County, South Carolina","1062668256","2600206    ","050","00","3","5","45061","45","061",20119,19701,418,26,392
"Lexington County","Lexington County, South Carolina","1811056191","151851421  ","050","00","3","5","45063","45","063",216014,209731,6283,2177,4106
"McCormick County","McCormick County, South Carolina","931268884","88802338   ","050","00","3","5","45065","45","065",9958,9899,59,57,2
"Marion County","Marion County, South Carolina","1266666996","13021005   ","050","00","3","5","45067","45","067",35466,34954,512,107,405
"Marlboro County","Marlboro County, South Carolina","1242431496","14430740   ","050","00","3","5","45069","45","069",28818,28646,172,96,76
"Newberry County","Newberry County, South Carolina","1633679224","42769875   ","050","00","3","5","45071","45","071",36108,34852,1256,187,1069
"Oconee County","Oconee County, South Carolina","1619801527","124752470  ","050","00","3","5","45073","45","073",66215,64619,1596,649,947
"Orangeburg County","Orangeburg County, South Carolina","2864932195","56807317   ","050","00","3","5","45075","45","075",91582,90656,926,509,417
"Pickens County","Pickens County, South Carolina","1286946741","38742501   ","050","00","3","5","45077","45","077",110757,107589,3168,852,2316
"Richland County","Richland County, South Carolina","1959103560","39629994   ","050","00","3","5","45079","45","079",320677,308031,12646,5444,7202
"Saluda County","Saluda County, South Carolina","1171916752","24094937   ","050","00","3","5","45081","45","081",19181,18041,1140,73,1067
"Spartanburg County","Spartanburg County, South Carolina","2100286619","21285592   ","050","00","3","5","45083","45","083",253791,244395,9396,3599,5797
"Sumter County","Sumter County, South Carolina","1723398538","43062241   ","050","00","3","5","45085","45","085",104646,102497,2149,990,1159
"Union County","Union County, South Carolina","1331558751","4658441    ","050","00","3","5","45087","45","087",29881,29695,186,122,64
"Williamsburg County","Williamsburg County, South Carolina","2418798697","7812114    ","050","00","3","5","45089","45","089",37217,37045,172,101,71
"York County","York County, South Carolina","1767547977","34364391   ","050","00","3","5","45091","45","091",164614,160634,3980,1478,2502
"Aurora County","Aurora County, South Dakota","1834174153","11267286   ","050","00","2","4","46003","46","003",3058,3012,46,19,27
"Beadle County","Beadle County, South Dakota","3260007889","15866631   ","050","00","2","4","46005","46","005",17023,16826,197,133,64
"Bennett County","Bennett County, South Dakota","3069889417","13724272   ","050","00","2","4","46007","46","007",3574,3561,13,3,10
"Bon Homme County","Bon Homme County, South Dakota","1459039627","46565966   ","050","00","2","4","46009","46","009",7260,7206,54,22,32
"Brookings County","Brookings County, South Dakota","2057636186","26687955   ","050","00","2","4","46011","46","011",28220,27567,653,253,400
"Brown County","Brown County, South Dakota","4436830444","46978597   ","050","00","2","4","46013","46","013",35460,35235,225,127,98
"Brule County","Brule County, South Dakota","2121089150","71321897   ","050","00","2","4","46015","46","015",5364,5340,24,24,0
"Buffalo County","Buffalo County, South Dakota","1218831895","43601707   ","050","00","2","4","46017","46","017",2032,2024,8,5,3
"Butte County","Butte County, South Dakota","5823617568","46216553   ","050","00","2","4","46019","46","019",9094,8987,107,57,50
"Campbell County","Campbell County, South Dakota","1905695487","92055341   ","050","00","2","4","46021","46","021",1782,1774,8,0,8
"Charles Mix County","Charles Mix County, South Dakota","2842698629","136270896  ","050","00","2","4","46023","46","023",9350,9277,73,41,32
"Clark County","Clark County, South Dakota","2481011655","25552139   ","050","00","2","4","46025","46","025",4143,4109,34,18,16
"Clay County","Clay County, South Dakota","1066040497","13206502   ","050","00","2","4","46027","46","027",13537,13189,348,88,260
"Codington County","Codington County, South Dakota","1781063200","76161811   ","050","00","2","4","46029","46","029",25897,25578,319,106,213
"Corson County","Corson County, South Dakota","6404871630","146289732  ","050","00","2","4","46031","46","031",4181,4169,12,6,6
"Custer County","Custer County, South Dakota","4034387392","3753880    ","050","00","2","4","46033","46","033",7275,7196,79,61,18
"Davison County","Davison County, South Dakota","1127785664","3465512    ","050","00","2","4","46035","46","035",18741,18553,188,71,117
"Day County","Day County, South Dakota","2663995168","162222176  ","050","00","2","4","46037","46","037",6267,6208,59,31,28
"Deuel County","Deuel County, South Dakota","1614987517","34109401   ","050","00","2","4","46039","46","039",4498,4468,30,9,21
"Dewey County","Dewey County, South Dakota","5963818882","370441783  ","050","00","2","4","46041","46","041",5972,5938,34,24,10
"Douglas County","Douglas County, South Dakota","1122830594","1565588    ","050","00","2","4","46043","46","043",3458,3444,14,14,0
"Edmunds County","Edmunds County, South Dakota","2967039229","14450306   ","050","00","2","4","46045","46","045",4367,4323,44,34,10
"Fall River County","Fall River County, South Dakota","4506221317","24037994   ","050","00","2","4","46047","46","047",7453,7412,41,35,6
"Faulk County","Faulk County, South Dakota","2590359110","14373398   ","050","00","2","4","46049","46","049",2640,2587,53,51,2
"Grant County","Grant County, South Dakota","1767701357","13987556   ","050","00","2","4","46051","46","051",7847,7763,84,55,29
"Gregory County","Gregory County, South Dakota","2631258515","97153372   ","050","00","2","4","46053","46","053",4792,4760,32,24,8
"Haakon County","Haakon County, South Dakota","4695563830","36926345   ","050","00","2","4","46055","46","055",2196,2175,21,7,14
"Hamlin County","Hamlin County, South Dakota","1312772879","80536463   ","050","00","2","4","46057","46","057",5540,5493,47,23,24
"Hand County","Hand County, South Dakota","3720726206","9409971    ","050","00","2","4","46059","46","059",3741,3703,38,32,6
"Hanson County","Hanson County, South Dakota","1126032844","2257697    ","050","00","2","4","46061","46","061",3139,3123,16,9,7
"Harding County","Harding County, South Dakota","6916558309","18334405   ","050","00","2","4","46063","46","063",1353,1346,7,0,7
"Hughes County","Hughes County, South Dakota","1918975480","153777208  ","050","00","2","4","46065","46","065",16481,16271,210,87,123
"Hutchinson County","Hutchinson County, South Dakota","2105192842","4025991    ","050","00","2","4","46067","46","067",8075,8018,57,38,19
"Hyde County","Hyde County, South Dakota","2229910882","14555117   ","050","00","2","4","46069","46","069",1671,1666,5,5,0
"Jackson County","Jackson County, South Dakota","4841012909","5488176    ","050","00","2","4","46071","46","071",2930,2904,26,12,14
"Jerauld County","Jerauld County, South Dakota","1372459111","7035098    ","050","00","2","4","46073","46","073",2295,2287,8,8,0
"Jones County","Jones County, South Dakota","2513636125","2945383    ","050","00","2","4","46075","46","075",1193,1193,0,0,0
"Kingsbury County","Kingsbury County, South Dakota","2171363087","65536905   ","050","00","2","4","46077","46","077",5815,5781,34,18,16
"Lake County","Lake County, South Dakota","1458755381","30633165   ","050","00","2","4","46079","46","079",11276,11176,100,63,37
"Lawrence County","Lawrence County, South Dakota","2072082384","722394     ","050","00","2","4","46081","46","081",21802,21536,266,134,132
"Lincoln County","Lincoln County, South Dakota","1497240329","1302473    ","050","00","2","4","46083","46","083",24131,23860,271,117,154
"Lyman County","Lyman County, South Dakota","4247473697","173779348  ","050","00","2","4","46085","46","085",3895,3873,22,14,8
"McCook County","McCook County, South Dakota","1487988123","6837306    ","050","00","2","4","46087","46","087",5832,5790,42,8,34
"McPherson County","McPherson County, South Dakota","2944654727","38613002   ","050","00","2","4","46089","46","089",2904,2880,24,10,14
"Marshall County","Marshall County, South Dakota","2169656047","124125081  ","050","00","2","4","46091","46","091",4576,4545,31,17,14
"Meade County","Meade County, South Dakota","8988899424","30619759   ","050","00","2","4","46093","46","093",24253,23907,346,180,166
"Mellette County","Mellette County, South Dakota","3383783385","8448583    ","050","00","2","4","46095","46","095",2083,2074,9,5,4
"Miner County","Miner County, South Dakota","1477163771","4274386    ","050","00","2","4","46097","46","097",2884,2873,11,11,0
"Minnehaha County","Minnehaha County, South Dakota","2097043873","10392481   ","050","00","2","4","46099","46","099",148281,142253,6028,1749,4279
"Moody County","Moody County, South Dakota","1345944602","3692498    ","050","00","2","4","46101","46","101",6595,6505,90,41,49
"Pennington County","Pennington County, South Dakota","7190183937","21134320   ","050","00","2","4","46103","46","103",88565,86666,1899,1044,855
"Perkins County","Perkins County, South Dakota","7437459147","49449397   ","050","00","2","4","46105","46","105",3363,3319,44,15,29
"Potter County","Potter County, South Dakota","2244193968","82724737   ","050","00","2","4","46107","46","107",2693,2679,14,9,5
"Roberts County","Roberts County, South Dakota","2852295107","88259266   ","050","00","2","4","46109","46","109",10016,9940,76,44,32
"Sanborn County","Sanborn County, South Dakota","1473735128","3107455    ","050","00","2","4","46111","46","111",2675,2659,16,12,4
"Shannon County","Shannon County, South Dakota","5423128251","7164474    ","050","00","2","4","46113","46","113",12466,12388,78,48,30
"Spink County","Spink County, South Dakota","3894999840","16015565   ","050","00","2","4","46115","46","115",7454,7411,43,36,7
"Stanley County","Stanley County, South Dakota","3738079326","190911503  ","050","00","2","4","46117","46","117",2772,2753,19,7,12
"Sully County","Sully County, South Dakota","2607857052","164361110  ","050","00","2","4","46119","46","119",1556,1544,12,8,4
"Todd County","Todd County, South Dakota","3595224903","7201394    ","050","00","2","4","46121","46","121",9050,8999,51,20,31
"Tripp County","Tripp County, South Dakota","4178998328","10037115   ","050","00","2","4","46123","46","123",6430,6406,24,16,8
"Turner County","Turner County, South Dakota","1597561452","1625140    ","050","00","2","4","46125","46","125",8849,8809,40,21,19
"Union County","Union County, South Dakota","1192367564","17364062   ","050","00","2","4","46127","46","127",12584,12277,307,114,193
"Walworth County","Walworth County, South Dakota","1833226695","94290637   ","050","00","2","4","46129","46","129",5974,5935,39,29,10
"Yankton County","Yankton County, South Dakota","1350810463","28659307   ","050","00","2","4","46135","46","135",21652,21317,335,123,212
"Ziebach County","Ziebach County, South Dakota","5082420849","22577745   ","050","00","2","4","46137","46","137",2519,2509,10,7,3
"Anderson County","Anderson County, Tennessee","874135757","18940279   ","050","00","3","6","47001","47","001",71330,69940,1390,552,838
"Bedford County","Bedford County, Tennessee","1226794030","3022869    ","050","00","3","6","47003","47","003",37586,35194,2392,222,2170
"Benton County","Benton County, Tennessee","1022626774","107136097  ","050","00","3","6","47005","47","005",16537,16416,121,41,80
"Bledsoe County","Bledsoe County, Tennessee","1052357777","1025779    ","050","00","3","6","47007","47","007",12367,12318,49,27,22
"Blount County","Blount County, Tennessee","1446668549","20935346   ","050","00","3","6","47009","47","009",105823,104189,1634,721,913
"Bradley County","Bradley County, Tennessee","851388731","7189343    ","050","00","3","6","47011","47","011",87965,86009,1956,649,1307
"Campbell County","Campbell County, Tennessee","1243370231","47103079   ","050","00","3","6","47013","47","013",39854,39550,304,111,193
"Cannon County","Cannon County, Tennessee","688013305","165149     ","050","00","3","6","47015","47","015",12826,12717,109,49,60
"Carroll County","Carroll County, Tennessee","1551460017","2164481    ","050","00","3","6","47017","47","017",29475,29148,327,156,171
"Carter County","Carter County, Tennessee","883304032","17017048   ","050","00","3","6","47019","47","019",56742,56291,451,214,237
"Cheatham County","Cheatham County, Tennessee","783883332","11588975   ","050","00","3","6","47021","47","021",35912,35500,412,244,168
"Chester County","Chester County, Tennessee","747259988","574242     ","050","00","3","6","47023","47","023",15540,15461,79,30,49
"Claiborne County","Claiborne County, Tennessee","1124775335","18825058   ","050","00","3","6","47025","47","025",29862,29601,261,86,175
"Clay County","Clay County, Tennessee","611521677","59941625   ","050","00","3","6","47027","47","027",7976,7888,88,48,40
"Cocke County","Cocke County, Tennessee","1125097707","22656110   ","050","00","3","6","47029","47","029",33565,33313,252,100,152
"Coffee County","Coffee County, Tennessee","1110699819","14554967   ","050","00","3","6","47031","47","031",48014,46908,1106,251,855
"Crockett County","Crockett County, Tennessee","687039953","536491     ","050","00","3","6","47033","47","033",14532,13964,568,96,472
"Cumberland County","Cumberland County, Tennessee","1765364462","8643761    ","050","00","3","6","47035","47","035",46802,45916,886,535,351
"Davidson County","Davidson County, Tennessee","1300859318","61767811   ","050","00","3","6","47037","47","037",569891,530295,39596,9891,29705
"Decatur County","Decatur County, Tennessee","864785444","28528201   ","050","00","3","6","47039","47","039",11731,11537,194,54,140
"DeKalb County","DeKalb County, Tennessee","788829647","63227382   ","050","00","3","6","47041","47","041",17423,16953,470,63,407
"Dickson County","Dickson County, Tennessee","1268749305","3671421    ","050","00","3","6","47043","47","043",43156,42836,320,208,112
"Dyer County","Dyer County, Tennessee","1322176856","41399101   ","050","00","3","6","47045","47","045",37279,36790,489,142,347
"Fayette County","Fayette County, Tennessee","1824642079","4478612    ","050","00","3","6","47047","47","047",28806,28600,206,138,68
"Fentress County","Fentress County, Tennessee","1291466761","866843     ","050","00","3","6","47049","47","049",16625,16563,62,44,18
"Franklin County","Franklin County, Tennessee","1436195584","55035205   ","050","00","3","6","47051","47","051",39270,38714,556,186,370
"Gibson County","Gibson County, Tennessee","1560916325","2369978    ","050","00","3","6","47053","47","053",48152,47753,399,127,272
"Giles County","Giles County, Tennessee","1582292632","643253     ","050","00","3","6","47055","47","055",29447,29183,264,87,177
"Grainger County","Grainger County, Tennessee","726058438","57264065   ","050","00","3","6","47057","47","057",20659,20436,223,66,157
"Greene County","Greene County, Tennessee","1610171770","6275600    ","050","00","3","6","47059","47","059",62909,62080,829,305,524
"Grundy County","Grundy County, Tennessee","933840913","1498661    ","050","00","3","6","47061","47","061",14332,14233,99,48,51
"Hamblen County","Hamblen County, Tennessee","417066000","38179374   ","050","00","3","6","47063","47","063",58128,55048,3080,539,2541
"Hamilton County","Hamilton County, Tennessee","1404914473","86205969   ","050","00","3","6","47065","47","065",307896,298599,9297,4038,5259
"Hancock County","Hancock County, Tennessee","575733130","3130241    ","050","00","3","6","47067","47","067",6786,6769,17,15,2
"Hardeman County","Hardeman County, Tennessee","1728937852","7367080    ","050","00","3","6","47069","47","069",28105,27905,200,80,120
"Hardin County","Hardin County, Tennessee","1496653754","47786645   ","050","00","3","6","47071","47","071",25578,25402,176,106,70
"Hawkins County","Hawkins County, Tennessee","1260434385","33601289   ","050","00","3","6","47073","47","073",53563,53198,365,196,169
"Haywood County","Haywood County, Tennessee","1380988427","2457761    ","050","00","3","6","47075","47","075",19797,19465,332,172,160
"Henderson County","Henderson County, Tennessee","1346855708","15256120   ","050","00","3","6","47077","47","077",25522,25348,174,97,77
"Henry County","Henry County, Tennessee","1454739484","82294669   ","050","00","3","6","47079","47","079",31115,30803,312,131,181
"Hickman County","Hickman County, Tennessee","1586420823","470400     ","050","00","3","6","47081","47","081",22295,22119,176,52,124
"Houston County","Houston County, Tennessee","518542241","17380920   ","050","00","3","6","47083","47","083",8088,7958,130,37,93
"Humphreys County","Humphreys County, Tennessee","1378437182","63460220   ","050","00","3","6","47085","47","085",17929,17762,167,81,86
"Jackson County","Jackson County, Tennessee","800005458","27639567   ","050","00","3","6","47087","47","087",10984,10811,173,116,57
"Jefferson County","Jefferson County, Tennessee","709174558","104927288  ","050","00","3","6","47089","47","089",44294,43617,677,146,531
"Johnson County","Johnson County, Tennessee","773034013","11037687   ","050","00","3","6","47091","47","091",17499,17391,108,51,57
"Knox County","Knox County, Tennessee","1316911987","44863695   ","050","00","3","6","47093","47","093",382032,372464,9568,4004,5564
"Lake County","Lake County, Tennessee","423249002","78677230   ","050","00","3","6","47095","47","095",7954,7911,43,13,30
"Lauderdale County","Lauderdale County, Tennessee","1218461978","95018943   ","050","00","3","6","47097","47","097",27101,26907,194,69,125
"Lawrence County","Lawrence County, Tennessee","1598463649","1922536    ","050","00","3","6","47099","47","099",39926,39581,345,112,233
"Lewis County","Lewis County, Tennessee","730619975","991041     ","050","00","3","6","47101","47","101",11367,11253,114,27,87
"Lincoln County","Lincoln County, Tennessee","1476900464","1013202    ","050","00","3","6","47103","47","103",31340,31062,278,123,155
"Loudon County","Loudon County, Tennessee","592800788","47731408   ","050","00","3","6","47105","47","105",39086,38380,706,227,479
"McMinn County","McMinn County, Tennessee","1114415725","5028646    ","050","00","3","6","47107","47","107",49015,48373,642,234,408
"McNairy County","McNairy County, Tennessee","1450509586","2054183    ","050","00","3","6","47109","47","109",24653,24419,234,70,164
"Macon County","Macon County, Tennessee","795465239","148587     ","050","00","3","6","47111","47","111",20386,20017,369,77,292
"Madison County","Madison County, Tennessee","1442622238","4231501    ","050","00","3","6","47113","47","113",91837,89763,2074,474,1600
"Marion County","Marion County, Tennessee","1290740760","36149071   ","050","00","3","6","47115","47","115",27776,27637,139,44,95
"Marshall County","Marshall County, Tennessee","972165017","1930300    ","050","00","3","6","47117","47","117",26767,26391,376,61,315
"Maury County","Maury County, Tennessee","1587311905","6887855    ","050","00","3","6","47119","47","119",69498,68052,1446,445,1001
"Meigs County","Meigs County, Tennessee","504689335","56776487   ","050","00","3","6","47121","47","121",11086,11015,71,59,12
"Monroe County","Monroe County, Tennessee","1644404983","45762713   ","050","00","3","6","47123","47","123",38961,38507,454,128,326
"Montgomery County","Montgomery County, Tennessee","1396721745","11829413   ","050","00","3","6","47125","47","125",134768,128863,5905,3117,2788
"Moore County","Moore County, Tennessee","334569920","3122226    ","050","00","3","6","47127","47","127",5740,5685,55,47,8
"Morgan County","Morgan County, Tennessee","1352087688","909345     ","050","00","3","6","47129","47","129",19757,19678,79,48,31
"Obion County","Obion County, Tennessee","1411321578","27017696   ","050","00","3","6","47131","47","131",32450,32015,435,91,344
"Overton County","Overton County, Tennessee","1122451532","3715574    ","050","00","3","6","47133","47","133",20118,20012,106,19,87
"Perry County","Perry County, Tennessee","1074570904","20724357   ","050","00","3","6","47135","47","135",7631,7594,37,12,25
"Pickett County","Pickett County, Tennessee","421955210","30200428   ","050","00","3","6","47137","47","137",4945,4931,14,7,7
"Polk County","Polk County, Tennessee","1126785516","18904940   ","050","00","3","6","47139","47","139",16050,15916,134,26,108
"Putnam County","Putnam County, Tennessee","1038725139","3894182    ","050","00","3","6","47141","47","141",62315,60185,2130,583,1547
"Rhea County","Rhea County, Tennessee","818272166","52968260   ","050","00","3","6","47143","47","143",28400,28027,373,158,215
"Roane County","Roane County, Tennessee","934946761","88049066   ","050","00","3","6","47145","47","145",51910,51279,631,358,273
"Robertson County","Robertson County, Tennessee","1234053037","525690     ","050","00","3","6","47147","47","147",54433,53067,1366,309,1057
"Rutherford County","Rutherford County, Tennessee","1602978872","13015399   ","050","00","3","6","47149","47","149",182023,175415,6608,2590,4018
"Scott County","Scott County, Tennessee","1378117192","2914571    ","050","00","3","6","47151","47","151",21127,21034,93,43,50
"Sequatchie County","Sequatchie County, Tennessee","688539063","461441     ","050","00","3","6","47153","47","153",11370,11238,132,24,108
"Sevier County","Sevier County, Tennessee","1534022656","14103794   ","050","00","3","6","47155","47","155",71170,70006,1164,547,617
"Shelby County","Shelby County, Tennessee","1954232183","75366890   ","050","00","3","6","47157","47","157",897472,863099,34373,11314,23059
"Smith County","Smith County, Tennessee","814329060","28324883   ","050","00","3","6","47159","47","159",17712,17561,151,52,99
"Stewart County","Stewart County, Tennessee","1187457841","89913901   ","050","00","3","6","47161","47","161",12370,12164,206,129,77
"Sullivan County","Sullivan County, Tennessee","1069723523","43163828   ","050","00","3","6","47163","47","163",153048,151112,1936,942,994
"Sumner County","Sumner County, Tennessee","1370885825","35777633   ","050","00","3","6","47165","47","165",130449,127341,3108,1177,1931
"Tipton County","Tipton County, Tennessee","1189757292","39767396   ","050","00","3","6","47167","47","167",51271,50840,431,220,211
"Trousdale County","Trousdale County, Tennessee","295880604","6227380    ","050","00","3","6","47169","47","169",7259,7139,120,35,85
"Unicoi County","Unicoi County, Tennessee","482091114","908243     ","050","00","3","6","47171","47","171",17667,17418,249,75,174
"Union County","Union County, Tennessee","579026577","61037419   ","050","00","3","6","47173","47","173",17808,17761,47,31,16
"Van Buren County","Van Buren County, Tennessee","708247711","2942886    ","050","00","3","6","47175","47","175",5508,5499,9,3,6
"Warren County","Warren County, Tennessee","1120650977","3614257    ","050","00","3","6","47177","47","177",38276,36854,1422,291,1131
"Washington County","Washington County, Tennessee","845134281","9046913    ","050","00","3","6","47179","47","179",107198,105195,2003,734,1269
"Wayne County","Wayne County, Tennessee","1900951057","4228819    ","050","00","3","6","47181","47","181",16842,16777,65,19,46
"Weakley County","Weakley County, Tennessee","1502680635","4208541    ","050","00","3","6","47183","47","183",34895,34189,706,238,468
"White County","White County, Tennessee","975342841","7261851    ","050","00","3","6","47185","47","185",23102,22919,183,102,81
"Williamson County","Williamson County, Tennessee","1509137258","2434473    ","050","00","3","6","47187","47","187",126638,121694,4944,1804,3140
"Wilson County","Wilson County, Tennessee","1477778414","32710334   ","050","00","3","6","47189","47","189",88809,87549,1260,525,735
"Anderson County","Anderson County, Texas","2773343426","18544033   ","050","00","3","7","48001","48","001",55109,53327,1782,596,1186
"Andrews County","Andrews County, Texas","3886634507","922340     ","050","00","3","7","48003","48","003",13004,11622,1382,471,911
"Angelina County","Angelina County, Texas","2076029951","162881123  ","050","00","3","7","48005","48","005",80130,74569,5561,1810,3751
"Aransas County","Aransas County, Texas","652313340","715072002  ","050","00","3","7","48007","48","007",22497,21213,1284,652,632
"Archer County","Archer County, Texas","2356107466","41663577   ","050","00","3","7","48009","48","009",8854,8650,204,79,125
"Armstrong County","Armstrong County, Texas","2366296248","459042     ","050","00","3","7","48011","48","011",2148,2128,20,8,12
"Atascosa County","Atascosa County, Texas","3191176671","9050001    ","050","00","3","7","48013","48","013",38628,36647,1981,917,1064
"Austin County","Austin County, Texas","1690208664","9794326    ","050","00","3","7","48015","48","015",23590,21870,1720,559,1161
"Bailey County","Bailey County, Texas","2141120935","1773619    ","050","00","3","7","48017","48","017",6594,5730,864,199,665
"Bandera County","Bandera County, Texas","2050562205","15046196   ","050","00","3","7","48019","48","019",17645,16950,695,291,404
"Bastrop County","Bastrop County, Texas","2300815542","19593718   ","050","00","3","7","48021","48","021",57733,53060,4673,1064,3609
"Baylor County","Baylor County, Texas","2255291906","78322299   ","050","00","3","7","48023","48","023",4093,4012,81,41,40
"Bee County","Bee County, Texas","2279560638","441064     ","050","00","3","7","48025","48","025",32359,31726,633,343,290
"Bell County","Bell County, Texas","2744659040","73058960   ","050","00","3","7","48027","48","027",237974,220652,17322,8278,9044
"Bexar County","Bexar County, Texas","3229259925","25479822   ","050","00","3","7","48029","48","029",1392931,1241591,151340,63432,87908
"Blanco County","Blanco County, Texas","1842110782","5606187    ","050","00","3","7","48031","48","031",8418,7999,419,154,265
"Borden County","Borden County, Texas","2327869219","18764214   ","050","00","3","7","48033","48","033",729,696,33,4,29
"Bosque County","Bosque County, Texas","2561952063","34851287   ","050","00","3","7","48035","48","035",17204,16449,755,312,443
"Bowie County","Bowie County, Texas","2299568076","90399498   ","050","00","3","7","48037","48","037",89306,87974,1332,528,804
"Brazoria County","Brazoria County, Texas","3590763752","546579181  ","050","00","3","7","48039","48","039",241767,221170,20597,7511,13086
"Brazos County","Brazos County, Texas","1517162791","11689911   ","050","00","3","7","48041","48","041",152415,136779,15636,3325,12311
"Brewster County","Brewster County, Texas","16038773182","455916     ","050","00","3","7","48043","48","043",8866,8251,615,179,436
"Briscoe County","Briscoe County, Texas","2331647724","3454102    ","050","00","3","7","48045","48","045",1790,1702,88,30,58
"Brooks County","Brooks County, Texas","2443078612","848053     ","050","00","3","7","48047","48","047",7976,7488,488,238,250
"Brown County","Brown County, Texas","2444567475","33886597   ","050","00","3","7","48049","48","049",37674,36492,1182,506,676
"Burleson County","Burleson County, Texas","1723751692","31697254   ","050","00","3","7","48051","48","051",16470,15968,502,216,286
"Burnet County","Burnet County, Texas","2579719178","64564368   ","050","00","3","7","48053","48","053",34147,32308,1839,541,1298
"Caldwell County","Caldwell County, Texas","1413424439","4364136    ","050","00","3","7","48055","48","055",32194,30541,1653,628,1025
"Calhoun County","Calhoun County, Texas","1326887971","1346383879 ","050","00","3","7","48057","48","057",20647,18891,1756,554,1202
"Callahan County","Callahan County, Texas","2327410648","6839969    ","050","00","3","7","48059","48","059",12905,12720,185,59,126
"Cameron County","Cameron County, Texas","2345898976","959791354  ","050","00","3","7","48061","48","061",335227,249504,85723,29571,56152
"Camp County","Camp County, Texas","511550919","14728248   ","050","00","3","7","48063","48","063",11549,10411,1138,207,931
"Carson County","Carson County, Texas","2391053170","2350480    ","050","00","3","7","48065","48","065",6516,6337,179,63,116
"Cass County","Cass County, Texas","2427732541","59551467   ","050","00","3","7","48067","48","067",30438,30108,330,136,194
"Castro County","Castro County, Texas","2326622504","2601240    ","050","00","3","7","48069","48","069",8285,7285,1000,392,608
"Chambers County","Chambers County, Texas","1552215787","706235748  ","050","00","3","7","48071","48","071",26031,24699,1332,468,864
"Cherokee County","Cherokee County, Texas","2725225009","25168053   ","050","00","3","7","48073","48","073",46659,42984,3675,848,2827
"Childress County","Childress County, Texas","1839768464","8475840    ","050","00","3","7","48075","48","075",7688,7323,365,165,200
"Clay County","Clay County, Texas","2843334012","47545451   ","050","00","3","7","48077","48","077",11006,10852,154,64,90
"Cochran County","Cochran County, Texas","2007810505","227238     ","050","00","3","7","48079","48","079",3730,3364,366,111,255
"Coke County","Coke County, Texas","2327904117","75539344   ","050","00","3","7","48081","48","081",3864,3757,107,47,60
"Coleman County","Coleman County, Texas","3263911556","55039215   ","050","00","3","7","48083","48","083",9235,8917,318,130,188
"Collin County","Collin County, Texas","2195162704","99169125   ","050","00","3","7","48085","48","085",491675,426396,65279,22237,43042
"Collingsworth County","Collingsworth County, Texas","2379671034","1663570    ","050","00","3","7","48087","48","087",3206,3069,137,81,56
"Colorado County","Colorado County, Texas","2494029601","27567896   ","050","00","3","7","48089","48","089",20390,18771,1619,440,1179
"Comal County","Comal County, Texas","1454137641","34054096   ","050","00","3","7","48091","48","091",78021,74300,3721,1540,2181
"Comanche County","Comanche County, Texas","2428607647","25845755   ","050","00","3","7","48093","48","093",14026,13027,999,203,796
"Concho County","Concho County, Texas","2567856416","5775933    ","050","00","3","7","48095","48","095",3966,3855,111,30,81
"Cooke County","Cooke County, Texas","2262704690","65191679   ","050","00","3","7","48097","48","097",36363,34353,2010,388,1622
"Coryell County","Coryell County, Texas","2724057814","12870627   ","050","00","3","7","48099","48","099",74978,71012,3966,2069,1897
"Cottle County","Cottle County, Texas","2334040035","1077637    ","050","00","3","7","48101","48","101",1904,1836,68,16,52
"Crane County","Crane County, Texas","2034584640","74934      ","050","00","3","7","48103","48","103",3996,3421,575,219,356
"Crockett County","Crockett County, Texas","7271173627","32084      ","050","00","3","7","48105","48","105",4099,3667,432,206,226
"Crosby County","Crosby County, Texas","2329728013","5632728    ","050","00","3","7","48107","48","107",7072,6797,275,125,150
"Culberson County","Culberson County, Texas","9874227547","635398     ","050","00","3","7","48109","48","109",2975,2512,463,295,168
"Dallam County","Dallam County, Texas","3897138301","1460688    ","050","00","3","7","48111","48","111",6222,5733,489,112,377
"Dallas County","Dallas County, Texas","2278150680","75003602   ","050","00","3","7","48113","48","113",2218899,1755325,463574,102201,361373
"Dawson County","Dawson County, Texas","2336328079","155200     ","050","00","3","7","48115","48","115",14985,14362,623,253,370
"Deaf Smith County","Deaf Smith County, Texas","3878080036","2393828    ","050","00","3","7","48117","48","117",18561,16409,2152,779,1373
"Delta County","Delta County, Texas","717621515","2179681    ","050","00","3","7","48119","48","119",5327,5302,25,11,14
"Denton County","Denton County, Texas","2301298150","179596965  ","050","00","3","7","48121","48","121",432976,392385,40591,14061,26530
"DeWitt County","DeWitt County, Texas","2354769327","3340199    ","050","00","3","7","48123","48","123",20013,19500,513,215,298
"Dickens County","Dickens County, Texas","2341888243","2600116    ","050","00","3","7","48125","48","125",2762,2707,55,19,36
"Dimmit County","Dimmit County, Texas","3447043984","9251938    ","050","00","3","7","48127","48","127",10248,9465,783,419,364
"Donley County","Donley County, Texas","2408096470","8483533    ","050","00","3","7","48129","48","129",3828,3765,63,14,49
"Duval County","Duval County, Texas","4643087506","7686162    ","050","00","3","7","48131","48","131",13120,12668,452,223,229
"Eastland County","Eastland County, Texas","2398365878","15251973   ","050","00","3","7","48133","48","133",18297,17560,737,265,472
"Ector County","Ector County, Texas","2333725529","1618368    ","050","00","3","7","48135","48","135",121123,108250,12873,5156,7717
"Edwards County","Edwards County, Texas","5490139198","496681     ","050","00","3","7","48137","48","137",2162,1929,233,140,93
"Ellis County","Ellis County, Texas","2434362808","30437957   ","050","00","3","7","48139","48","139",111360,103453,7907,2031,5876
"El Paso County","El Paso County, Texas","2623932741","4064344    ","050","00","3","7","48141","48","141",679622,493454,186168,77821,108347
"Erath County","Erath County, Texas","2813575524","8989076    ","050","00","3","7","48143","48","143",33001,30587,2414,837,1577
"Falls County","Falls County, Texas","1991935318","12215375   ","050","00","3","7","48145","48","145",18576,17714,862,314,548
"Fannin County","Fannin County, Texas","2308852674","19963433   ","050","00","3","7","48147","48","147",31242,30271,971,194,777
"Fayette County","Fayette County, Texas","2460557007","25418039   ","050","00","3","7","48149","48","149",21804,20573,1231,363,868
"Fisher County","Fisher County, Texas","2333995197","1504872    ","050","00","3","7","48151","48","151",4344,4244,100,36,64
"Floyd County","Floyd County, Texas","2569758750","821362     ","050","00","3","7","48153","48","153",7771,7312,459,216,243
"Foard County","Foard County, Texas","1830285768","2621410    ","050","00","3","7","48155","48","155",1622,1596,26,14,12
"Fort Bend County","Fort Bend County, Texas","2265308727","29542912   ","050","00","3","7","48157","48","157",354452,289574,64878,30828,34050
"Franklin County","Franklin County, Texas","739849574","23608885   ","050","00","3","7","48159","48","159",9458,8947,511,110,401
"Freestone County","Freestone County, Texas","2272530826","38085466   ","050","00","3","7","48161","48","161",17867,17318,549,137,412
"Frio County","Frio County, Texas","2934513897","3266120    ","050","00","3","7","48163","48","163",16252,15306,946,440,506
"Gaines County","Gaines County, Texas","3891069648","1270535    ","050","00","3","7","48165","48","165",14467,11726,2741,1137,1604
"Galveston County","Galveston County, Texas","1032033925","1228838493 ","050","00","3","7","48167","48","167",250158,229480,20678,7233,13445
"Garza County","Garza County, Texas","2319490709","1620915    ","050","00","3","7","48169","48","169",4872,4565,307,162,145
"Gillespie County","Gillespie County, Texas","2748138559","1087810    ","050","00","3","7","48171","48","171",20814,19351,1463,473,990
"Glasscock County","Glasscock County, Texas","2332919483","479504     ","050","00","3","7","48173","48","173",1406,1208,198,66,132
"Goliad County","Goliad County, Texas","2210601524","15096180   ","050","00","3","7","48175","48","175",6928,6731,197,69,128
"Gonzales County","Gonzales County, Texas","2765459447","5370804    ","050","00","3","7","48177","48","177",18628,16581,2047,688,1359
"Gray County","Gray County, Texas","2404226608","2517095    ","050","00","3","7","48179","48","179",22744,21756,988,301,687
"Grayson County","Grayson County, Texas","2417785952","118311716  ","050","00","3","7","48181","48","181",110595,106266,4329,1096,3233
"Gregg County","Gregg County, Texas","709735324","6068837    ","050","00","3","7","48183","48","183",111379,105326,6053,1691,4362
"Grimes County","Grimes County, Texas","2055421820","19583224   ","050","00","3","7","48185","48","185",23552,22364,1188,358,830
"Guadalupe County","Guadalupe County, Texas","1841847082","7845749    ","050","00","3","7","48187","48","187",89023,83222,5801,2505,3296
"Hale County","Hale County, Texas","2602041712","298615     ","050","00","3","7","48189","48","189",36602,33598,3004,1050,1954
"Hall County","Hall County, Texas","2338979526","2568031    ","050","00","3","7","48191","48","191",3782,3438,344,86,258
"Hamilton County","Hamilton County, Texas","2164469099","1743061    ","050","00","3","7","48193","48","193",8229,7924,305,74,231
"Hansford County","Hansford County, Texas","2382272862","1554159    ","050","00","3","7","48195","48","195",5369,4532,837,212,625
"Hardeman County","Hardeman County, Texas","1801021454","4201347    ","050","00","3","7","48197","48","197",4724,4605,119,55,64
"Hardin County","Hardin County, Texas","2316312268","7870105    ","050","00","3","7","48199","48","199",48073,47469,604,325,279
"Harris County","Harris County, Texas","4477636200","126570235  ","050","00","3","7","48201","48","201",3400578,2644030,756548,223609,532939
"Harrison County","Harrison County, Texas","2327637984","42428648   ","050","00","3","7","48203","48","203",62110,60050,2060,541,1519
"Hartley County","Hartley County, Texas","3787211615","2457266    ","050","00","3","7","48205","48","205",5537,5391,146,43,103
"Haskell County","Haskell County, Texas","2338673402","18871082   ","050","00","3","7","48207","48","207",6093,5873,220,62,158
"Hays County","Hays County, Texas","1755681187","4977463    ","050","00","3","7","48209","48","209",97589,92151,5438,1831,3607
"Hemphill County","Hemphill County, Texas","2356051113","6164977    ","050","00","3","7","48211","48","211",3351,3133,218,70,148
"Henderson County","Henderson County, Texas","2264260076","193636334  ","050","00","3","7","48213","48","213",73277,70463,2814,779,2035
"Hidalgo County","Hidalgo County, Texas","4065624249","33456472   ","050","00","3","7","48215","48","215",569463,401248,168215,48474,119741
"Hill County","Hill County, Texas","2492501234","60315182   ","050","00","3","7","48217","48","217",32321,30412,1909,599,1310
"Hockley County","Hockley County, Texas","2352432879","691489     ","050","00","3","7","48219","48","219",22716,21540,1176,480,696
"Hood County","Hood County, Texas","1091966384","39340655   ","050","00","3","7","48221","48","221",41100,39761,1339,529,810
"Hopkins County","Hopkins County, Texas","2026400831","26799005   ","050","00","3","7","48223","48","223",31960,30172,1788,525,1263
"Houston County","Houston County, Texas","3187994422","15393128   ","050","00","3","7","48225","48","225",23185,22483,702,122,580
"Howard County","Howard County, Texas","2338339550","3510749    ","050","00","3","7","48227","48","227",33627,31612,2015,549,1466
"Hudspeth County","Hudspeth County, Texas","11838840971","2402329    ","050","00","3","7","48229","48","229",3344,2234,1110,311,799
"Hunt County","Hunt County, Texas","2178586457","105846457  ","050","00","3","7","48231","48","231",76596,72995,3601,967,2634
"Hutchinson County","Hutchinson County, Texas","2298272229","19631084   ","050","00","3","7","48233","48","233",23857,22472,1385,350,1035
"Irion County","Irion County, Texas","2723308823","291335     ","050","00","3","7","48235","48","235",1771,1709,62,35,27
"Jack County","Jack County, Texas","2374006877","9077349    ","050","00","3","7","48237","48","237",8763,8522,241,85,156
"Jackson County","Jackson County, Texas","2148371018","71315600   ","050","00","3","7","48239","48","239",14391,13701,690,126,564
"Jasper County","Jasper County, Texas","2427844000","83458684   ","050","00","3","7","48241","48","241",35604,34829,775,197,578
"Jeff Davis County","Jeff Davis County, Texas","5864838926","459348     ","050","00","3","7","48243","48","243",2207,1967,240,64,176
"Jefferson County","Jefferson County, Texas","2340170834","537971766  ","050","00","3","7","48245","48","245",252051,236443,15608,5727,9881
"Jim Hogg County","Jim Hogg County, Texas","2942511204","140391     ","050","00","3","7","48247","48","247",5281,5011,270,126,144
"Jim Wells County","Jim Wells County, Texas","2239089456","9601293    ","050","00","3","7","48249","48","249",39326,37913,1413,660,753
"Johnson County","Johnson County, Texas","1889198737","13037107   ","050","00","3","7","48251","48","251",126811,120241,6570,2312,4258
"Jones County","Jones County, Texas","2411259657","15894244   ","050","00","3","7","48253","48","253",20785,20459,326,208,118
"Karnes County","Karnes County, Texas","1943312521","8462078    ","050","00","3","7","48255","48","255",15446,14882,564,174,390
"Kaufman County","Kaufman County, Texas","2035841232","53774580   ","050","00","3","7","48257","48","257",71313,67274,4039,1303,2736
"Kendall County","Kendall County, Texas","1715713677","1561929    ","050","00","3","7","48259","48","259",23743,22418,1325,583,742
"Kenedy County","Kenedy County, Texas","3773010533","1266067224 ","050","00","3","7","48261","48","261",414,359,55,32,23
"Kent County","Kent County, Texas","2337024572","1490921    ","050","00","3","7","48263","48","263",859,844,15,9,6
"Kerr County","Kerr County, Texas","2864843926","3988306    ","050","00","3","7","48265","48","265",43653,40754,2899,1090,1809
"Kimble County","Kimble County, Texas","3239286360","583223     ","050","00","3","7","48267","48","267",4468,4222,246,65,181
"King County","King County, Texas","2362826410","2685451    ","050","00","3","7","48269","48","269",356,348,8,0,8
"Kinney County","Kinney County, Texas","3531291789","4833582    ","050","00","3","7","48271","48","271",3379,2982,397,191,206
"Kleberg County","Kleberg County, Texas","2255813548","568033430  ","050","00","3","7","48273","48","273",31549,29494,2055,835,1220
"Knox County","Knox County, Texas","2198908360","16649720   ","050","00","3","7","48275","48","275",4253,3967,286,139,147
"Lamar County","Lamar County, Texas","2374518404","40564794   ","050","00","3","7","48277","48","277",48499,47493,1006,306,700
"Lamb County","Lamb County, Texas","2631978707","3931575    ","050","00","3","7","48279","48","279",14709,13781,928,334,594
"Lampasas County","Lampasas County, Texas","1844176651","4976251    ","050","00","3","7","48281","48","281",17762,16704,1058,500,558
"La Salle County","La Salle County, Texas","3856100912","13930617   ","050","00","3","7","48283","48","283",5866,5633,233,103,130
"Lavaca County","Lavaca County, Texas","2512032709","1159937    ","050","00","3","7","48285","48","285",19210,18723,487,182,305
"Lee County","Lee County, Texas","1627809365","14333023   ","050","00","3","7","48287","48","287",15657,14697,960,212,748
"Leon County","Leon County, Texas","2776570491","21593482   ","050","00","3","7","48289","48","289",15335,14684,651,147,504
"Liberty County","Liberty County, Texas","3003552406","42850906   ","050","00","3","7","48291","48","291",70154,66591,3563,739,2824
"Limestone County","Limestone County, Texas","2353981956","62865980   ","050","00","3","7","48293","48","293",22051,20835,1216,246,970
"Lipscomb County","Lipscomb County, Texas","2414153807","289494     ","050","00","3","7","48295","48","295",3057,2700,357,85,272
"Live Oak County","Live Oak County, Texas","2683999432","110160259  ","050","00","3","7","48297","48","297",12309,12025,284,137,147
"Llano County","Llano County, Texas","2421028149","81355785   ","050","00","3","7","48299","48","299",17044,16696,348,125,223
"Loving County","Loving County, Texas","1743272685","9760042    ","050","00","3","7","48301","48","301",67,67,0,0,0
"Lubbock County","Lubbock County, Texas","2329677242","3115562    ","050","00","3","7","48303","48","303",242628,234513,8115,3617,4498
"Lynn County","Lynn County, Texas","2309964999","4079435    ","050","00","3","7","48305","48","305",6550,6221,329,100,229
"McCulloch County","McCulloch County, Texas","2769488307","10478800   ","050","00","3","7","48307","48","307",8205,7941,264,83,181
"McLennan County","McLennan County, Texas","2698463849","47509238   ","050","00","3","7","48309","48","309",213517,200398,13119,3707,9412
"McMullen County","McMullen County, Texas","2882656841","76674679   ","050","00","3","7","48311","48","311",851,815,36,2,34
"Madison County","Madison County, Texas","1216381800","7242480    ","050","00","3","7","48313","48","313",12940,12321,619,183,436
"Marion County","Marion County, Texas","987323553","101400078  ","050","00","3","7","48315","48","315",10941,10848,93,44,49
"Martin County","Martin County, Texas","2369282061","2169665    ","050","00","3","7","48317","48","317",4746,4362,384,94,290
"Mason County","Mason County, Texas","2414040796","292441     ","050","00","3","7","48319","48","319",3738,3561,177,58,119
"Matagorda County","Matagorda County, Texas","2886439165","1289110879 ","050","00","3","7","48321","48","321",37957,34197,3760,1062,2698
"Maverick County","Maverick County, Texas","3315379558","30211885   ","050","00","3","7","48323","48","323",47297,29430,17867,7164,10703
"Medina County","Medina County, Texas","3438885559","17523238   ","050","00","3","7","48325","48","325",39304,37687,1617,757,860
"Menard County","Menard County, Texas","2335942696","877450     ","050","00","3","7","48327","48","327",2360,2246,114,49,65
"Midland County","Midland County, Texas","2331637115","4442320    ","050","00","3","7","48329","48","329",116009,107222,8787,3514,5273
"Milam County","Milam County, Texas","2633278710","12830958   ","050","00","3","7","48331","48","331",24238,22891,1347,486,861
"Mills County","Mills County, Texas","1937595854","4602714    ","050","00","3","7","48333","48","333",5151,4926,225,68,157
"Mitchell County","Mitchell County, Texas","2356990934","15169548   ","050","00","3","7","48335","48","335",9698,9426,272,102,170
"Montague County","Montague County, Texas","2410403362","20139027   ","050","00","3","7","48337","48","337",19117,18649,468,91,377
"Montgomery County","Montgomery County, Texas","2704020613","84909518   ","050","00","3","7","48339","48","339",293768,268492,25276,7715,17561
"Moore County","Moore County, Texas","2330116657","25773583   ","050","00","3","7","48341","48","341",20121,15919,4202,933,3269
"Morris County","Morris County, Texas","659180684","10693274   ","050","00","3","7","48343","48","343",13048,12784,264,125,139
"Motley County","Motley County, Texas","2562476841","1114580    ","050","00","3","7","48345","48","345",1426,1379,47,16,31
"Nacogdoches County","Nacogdoches County, Texas","2452114653","89521717   ","050","00","3","7","48347","48","347",59203,55523,3680,871,2809
"Navarro County","Navarro County, Texas","2609839096","203332416  ","050","00","3","7","48349","48","349",45124,41040,4084,838,3246
"Newton County","Newton County, Texas","2415658616","17653209   ","050","00","3","7","48351","48","351",15072,14940,132,64,68
"Nolan County","Nolan County, Texas","2362020780","5036773    ","050","00","3","7","48353","48","353",15802,15133,669,380,289
"Nueces County","Nueces County, Texas","2164755364","856257213  ","050","00","3","7","48355","48","355",313645,293139,20506,9113,11393
"Ochiltree County","Ochiltree County, Texas","2376457525","1331759    ","050","00","3","7","48357","48","357",9006,7554,1452,243,1209
"Oldham County","Oldham County, Texas","3886615734","2037484    ","050","00","3","7","48359","48","359",2185,2067,118,37,81
"Orange County","Orange County, Texas","923081422","59921529   ","050","00","3","7","48361","48","361",84966,83203,1763,874,889
"Palo Pinto County","Palo Pinto County, Texas","2468071967","84348718   ","050","00","3","7","48363","48","363",27026,25825,1201,442,759
"Panola County","Panola County, Texas","2074375834","52882803   ","050","00","3","7","48365","48","365",22756,22100,656,178,478
"Parker County","Parker County, Texas","2340069020","17049193   ","050","00","3","7","48367","48","367",88495,86154,2341,920,1421
"Parmer County","Parmer County, Texas","2283491737","9079355    ","050","00","3","7","48369","48","369",10016,7999,2017,685,1332
"Pecos County","Pecos County, Texas","12337816783","2778713    ","050","00","3","7","48371","48","371",16809,14538,2271,952,1319
"Polk County","Polk County, Texas","2738296787","136107497  ","050","00","3","7","48373","48","373",41133,39349,1784,684,1100
"Potter County","Potter County, Texas","2354929123","32987793   ","050","00","3","7","48375","48","375",113546,102853,10693,3859,6834
"Presidio County","Presidio County, Texas","9985712134","1942105    ","050","00","3","7","48377","48","377",7304,4689,2615,580,2035
"Rains County","Rains County, Texas","601006894","69462780   ","050","00","3","7","48379","48","379",9139,8912,227,70,157
"Randall County","Randall County, Texas","2368367866","20689763   ","050","00","3","7","48381","48","381",104312,101564,2748,1183,1565
"Reagan County","Reagan County, Texas","3044018790","1767643    ","050","00","3","7","48383","48","383",3326,2779,547,145,402
"Real County","Real County, Texas","1812766238","337354     ","050","00","3","7","48385","48","385",3047,2924,123,64,59
"Red River County","Red River County, Texas","2719962161","19245106   ","050","00","3","7","48387","48","387",14314,13951,363,139,224
"Reeves County","Reeves County, Texas","6826888706","15733111   ","050","00","3","7","48389","48","389",13137,11206,1931,815,1116
"Refugio County","Refugio County, Texas","1994828931","125439086  ","050","00","3","7","48391","48","391",7828,7621,207,97,110
"Roberts County","Roberts County, Texas","2393387054","253733     ","050","00","3","7","48393","48","393",887,883,4,2,2
"Robertson County","Robertson County, Texas","2213312199","28765353   ","050","00","3","7","48395","48","395",16000,15480,520,158,362
"Rockwall County","Rockwall County, Texas","333553739","51571092   ","050","00","3","7","48397","48","397",43080,39716,3364,1312,2052
"Runnels County","Runnels County, Texas","2721376387","16573842   ","050","00","3","7","48399","48","399",11495,10977,518,141,377
"Rusk County","Rusk County, Texas","2391980683","39030740   ","050","00","3","7","48401","48","401",47372,45269,2103,538,1565
"Sabine County","Sabine County, Texas","1269790346","223625764  ","050","00","3","7","48403","48","403",10469,10352,117,45,72
"San Augustine County","San Augustine County, Texas","1367187977","166629181  ","050","00","3","7","48405","48","405",8946,8764,182,82,100
"San Jacinto County","San Jacinto County, Texas","1477988673","148264361  ","050","00","3","7","48407","48","407",22246,21689,557,138,419
"San Patricio County","San Patricio County, Texas","1791368475","39911748   ","050","00","3","7","48409","48","409",67138,64933,2205,990,1215
"San Saba County","San Saba County, Texas","2938251646","9795910    ","050","00","3","7","48411","48","411",6186,5843,343,109,234
"Schleicher County","Schleicher County, Texas","3394463574","112754     ","050","00","3","7","48413","48","413",2935,2527,408,155,253
"Scurry County","Scurry County, Texas","2337459972","13038421   ","050","00","3","7","48415","48","415",16361,15854,507,180,327
"Shackelford County","Shackelford County, Texas","2367121102","4105291    ","050","00","3","7","48417","48","417",3302,3205,97,55,42
"Shelby County","Shelby County, Texas","2056734109","104701410  ","050","00","3","7","48419","48","419",25224,23570,1654,300,1354
"Sherman County","Sherman County, Texas","2390641547","422949     ","050","00","3","7","48421","48","421",3186,2792,394,122,272
"Smith County","Smith County, Texas","2404501444","54556496   ","050","00","3","7","48423","48","423",174706,163103,11603,3344,8259
"Somervell County","Somervell County, Texas","484762566","12251698   ","050","00","3","7","48425","48","425",6809,6422,387,114,273
"Starr County","Starr County, Texas","3167618319","16200751   ","050","00","3","7","48427","48","427",53597,33839,19758,6290,13468
"Stephens County","Stephens County, Texas","2317109919","69506701   ","050","00","3","7","48429","48","429",9674,9032,642,159,483
"Sterling County","Sterling County, Texas","2391485484","341137     ","050","00","3","7","48431","48","431",1393,1265,128,41,87
"Stonewall County","Stonewall County, Texas","2379345373","4046602    ","050","00","3","7","48433","48","433",1693,1659,34,8,26
"Sutton County","Sutton County, Texas","3765230979","1638824    ","050","00","3","7","48435","48","435",4077,3548,529,194,335
"Swisher County","Swisher County, Texas","2332099282","643358     ","050","00","3","7","48437","48","437",8378,7965,413,158,255
"Tarrant County","Tarrant County, Texas","2236243955","88220413   ","050","00","3","7","48439","48","439",1446219,1262996,183223,56074,127149
"Taylor County","Taylor County, Texas","2371459979","9391045    ","050","00","3","7","48441","48","441",126555,121533,5022,2008,3014
"Terrell County","Terrell County, Texas","6106466336","85206      ","050","00","3","7","48443","48","443",1081,974,107,30,77
"Terry County","Terry County, Texas","2304766336","2742784    ","050","00","3","7","48445","48","445",12761,11845,916,265,651
"Throckmorton County","Throckmorton County, Texas","2362944570","8109905    ","050","00","3","7","48447","48","447",1850,1820,30,4,26
"Titus County","Titus County, Texas","1063280774","39250144   ","050","00","3","7","48449","48","449",28118,23218,4900,1350,3550
"Tom Green County","Tom Green County, Texas","3942213774","47758522   ","050","00","3","7","48451","48","451",104010,97849,6161,2825,3336
"Travis County","Travis County, Texas","2562287673","84883107   ","050","00","3","7","48453","48","453",812280,689659,122621,32375,90246
"Trinity County","Trinity County, Texas","1794459095","54799514   ","050","00","3","7","48455","48","455",13779,13411,368,117,251
"Tyler County","Tyler County, Texas","2390308009","33167531   ","050","00","3","7","48457","48","457",20871,20614,257,90,167
"Upshur County","Upshur County, Texas","1521988201","13011230   ","050","00","3","7","48459","48","459",35291,34594,697,272,425
"Upton County","Upton County, Texas","3215926954","410400     ","050","00","3","7","48461","48","461",3404,3023,381,122,259
"Uvalde County","Uvalde County, Texas","4031439700","5327766    ","050","00","3","7","48463","48","463",25926,23021,2905,1179,1726
"Val Verde County","Val Verde County, Texas","8211240629","160625533  ","050","00","3","7","48465","48","465",44856,34362,10494,4110,6384
"Van Zandt County","Van Zandt County, Texas","2197977016","28072492   ","050","00","3","7","48467","48","467",48140,46403,1737,467,1270
"Victoria County","Victoria County, Texas","2285676788","16124140   ","050","00","3","7","48469","48","469",84088,80503,3585,1407,2178
"Walker County","Walker County, Texas","2039485079","36226305   ","050","00","3","7","48471","48","471",61758,59002,2756,879,1877
"Waller County","Waller County, Texas","1330290181","12600777   ","050","00","3","7","48473","48","473",32663,29591,3072,668,2404
"Ward County","Ward County, Texas","2163914893","652960     ","050","00","3","7","48475","48","475",10909,10190,719,350,369
"Washington County","Washington County, Texas","1577876579","31403814   ","050","00","3","7","48477","48","477",30373,28731,1642,564,1078
"Webb County","Webb County, Texas","8694158147","48417791   ","050","00","3","7","48479","48","479",193117,137088,56029,18867,37162
"Wharton County","Wharton County, Texas","2823427017","11122548   ","050","00","3","7","48481","48","481",41188,38464,2724,694,2030
"Wheeler County","Wheeler County, Texas","2367934666","2786352    ","050","00","3","7","48483","48","483",5284,4997,287,93,194
"Wichita County","Wichita County, Texas","1625640947","13849876   ","050","00","3","7","48485","48","485",131664,124933,6731,2924,3807
"Wilbarger County","Wilbarger County, Texas","2515040549","18217048   ","050","00","3","7","48487","48","487",14676,14054,622,227,395
"Willacy County","Willacy County, Texas","1545397740","485746176  ","050","00","3","7","48489","48","489",20082,17415,2667,1196,1471
"Williamson County","Williamson County, Texas","2907952035","31011595   ","050","00","3","7","48491","48","491",249967,231518,18449,7485,10964
"Wilson County","Wilson County, Texas","2090083754","4102967    ","050","00","3","7","48493","48","493",32408,31346,1062,526,536
"Winkler County","Winkler County, Texas","2178300896","501201     ","050","00","3","7","48495","48","495",7173,6147,1026,300,726
"Wise County","Wise County, Texas","2342919126","47052272   ","050","00","3","7","48497","48","497",48793,46312,2481,819,1662
"Wood County","Wood County, Texas","1684066475","118043808  ","050","00","3","7","48499","48","499",36752,35373,1379,549,830
"Yoakum County","Yoakum County, Texas","2071347206","33581      ","050","00","3","7","48501","48","501",7322,6105,1217,325,892
"Young County","Young County, Texas","2388829028","22047971   ","050","00","3","7","48503","48","503",17943,17285,658,177,481
"Zapata County","Zapata County, Texas","2581596039","158880744  ","050","00","3","7","48505","48","505",12182,9251,2931,1057,1874
"Zavala County","Zavala County, Texas","3363050874","8385180    ","050","00","3","7","48507","48","507",11600,10002,1598,809,789
"Beaver County","Beaver County, Utah","6707930400","6039597    ","050","00","4","8","49001","49","001",6005,5742,263,76,187
"Box Elder County","Box Elder County, Utah","14823390253","2604722395 ","050","00","4","8","49003","49","003",42745,41476,1269,469,800
"Cache County","Cache County, Utah","3016100832","22144785   ","050","00","4","8","49005","49","005",91391,85309,6082,1338,4744
"Carbon County","Carbon County, Utah","3829188016","15839896   ","050","00","4","8","49007","49","007",20422,20019,403,193,210
"Daggett County","Daggett County, Utah","1808737094","63986618   ","050","00","4","8","49009","49","009",921,896,25,12,13
"Davis County","Davis County, Utah","788595522","852681404  ","050","00","4","8","49011","49","011",238994,230300,8694,4262,4432
"Duchesne County","Duchesne County, Utah","8386517838","46407205   ","050","00","4","8","49013","49","013",14371,14187,184,88,96
"Emery County","Emery County, Utah","11530241878","25099464   ","050","00","4","8","49015","49","015",10860,10588,272,98,174
"Garfield County","Garfield County, Utah","13401163195","88002922   ","050","00","4","8","49017","49","017",4735,4696,39,19,20
"Grand County","Grand County, Utah","9535196504","32415485   ","050","00","4","8","49019","49","019",8485,8228,257,107,150
"Iron County","Iron County, Utah","8541717322","10012113   ","050","00","4","8","49021","49","021",33779,32798,981,294,687
"Juab County","Juab County, Utah","8784559992","37665310   ","050","00","4","8","49023","49","023",8238,8126,112,49,63
"Kane County","Kane County, Utah","10339128016","301638425  ","050","00","4","8","49025","49","025",6046,5868,178,95,83
"Millard County","Millard County, Utah","17065775108","618680802  ","050","00","4","8","49027","49","027",12405,11767,638,126,512
"Morgan County","Morgan County, Utah","1577633092","4307801    ","050","00","4","8","49029","49","029",7129,6933,196,110,86
"Piute County","Piute County, Utah","1962717292","20590826   ","050","00","4","8","49031","49","031",1435,1406,29,6,23
"Rich County","Rich County, Utah","2663892098","149597387  ","050","00","4","8","49033","49","033",1961,1923,38,10,28
"Salt Lake County","Salt Lake County, Utah","1909799816","182340759  ","050","00","4","8","49035","49","035",898387,805111,93276,28519,64757
"San Juan County","San Juan County, Utah","20254162556","292442718  ","050","00","4","8","49037","49","037",14413,14283,130,53,77
"Sanpete County","Sanpete County, Utah","4113174578","37685096   ","050","00","4","8","49039","49","039",22763,21675,1088,239,849
"Sevier County","Sevier County, Utah","4947521825","20794177   ","050","00","4","8","49041","49","041",18842,18598,244,101,143
"Summit County","Summit County, Utah","4845990629","28486127   ","050","00","4","8","49043","49","043",29736,27437,2299,534,1765
"Tooele County","Tooele County, Utah","17949532649","924010935  ","050","00","4","8","49045","49","045",40735,39231,1504,349,1155
"Uintah County","Uintah County, Utah","11595569027","56744414   ","050","00","4","8","49047","49","047",25224,24883,341,163,178
"Utah County","Utah County, Utah","5175657032","369442863  ","050","00","4","8","49049","49","049",368536,345349,23187,6049,17138
"Wasatch County","Wasatch County, Utah","3049423729","82301572   ","050","00","4","8","49051","49","051",15215,14575,640,155,485
"Washington County","Washington County, Utah","6284929122","8499344    ","050","00","4","8","49053","49","053",90354,86640,3714,1398,2316
"Wayne County","Wayne County, Utah","6372196292","15925827   ","050","00","4","8","49055","49","055",2509,2466,43,18,25
"Weber County","Weber County, Utah","1490637821","217367964  ","050","00","4","8","49057","49","057",196533,183995,12538,3248,9290
"Addison County","Addison County, Vermont","1994757635","98734144   ","050","00","1","1","50001","50","001",35974,34732,1242,610,632
"Bennington County","Bennington County, Vermont","1751528984","3620994    ","050","00","1","1","50003","50","003",36994,36000,994,577,417
"Caledonia County","Caledonia County, Vermont","1685008488","17967936   ","050","00","1","1","50005","50","005",29702,28957,745,427,318
"Chittenden County","Chittenden County, Vermont","1396111793","208755559  ","050","00","1","1","50007","50","007",146571,137902,8669,3939,4730
"Essex County","Essex County, Vermont","1722851853","22157822   ","050","00","1","1","50009","50","009",6459,6106,353,218,135
"Franklin County","Franklin County, Vermont","1650008857","142307050  ","050","00","1","1","50011","50","011",45417,43730,1687,1028,659
"Grand Isle County","Grand Isle County, Vermont","213974970","290224577  ","050","00","1","1","50013","50","013",6901,6610,291,152,139
"Lamoille County","Lamoille County, Vermont","1193896631","7206252    ","050","00","1","1","50015","50","015",23233,22345,888,462,426
"Orange County","Orange County, Vermont","1783355796","8241572    ","050","00","1","1","50017","50","017",28226,27724,502,286,216
"Orleans County","Orleans County, Vermont","1807034942","60715709   ","050","00","1","1","50019","50","019",26277,24831,1446,971,475
"Rutland County","Rutland County, Vermont","2415236619","31712989   ","050","00","1","1","50021","50","021",63400,62153,1247,797,450
"Washington County","Washington County, Vermont","1784931569","16212476   ","050","00","1","1","50023","50","023",58039,55924,2115,1117,998
"Windham County","Windham County, Vermont","2042771982","24346572   ","050","00","1","1","50025","50","025",44216,42858,1358,841,517
"Windsor County","Windsor County, Vermont","2514776699","12367343   ","050","00","1","1","50027","50","027",57418,55710,1708,1026,682
"Accomack County","Accomack County, Virginia","1179077243","2213926909 ","050","00","3","5","51001","51","001",38305,36680,1625,286,1339
"Albemarle County","Albemarle County, Virginia","1871543150","9259586    ","050","00","3","5","51003","51","003",79236,73483,5753,1791,3962
"Alleghany County","Alleghany County, Virginia","1151576760","2696311    ","050","00","3","5","51005","51","005",12926,12814,112,62,50
"Amelia County","Amelia County, Virginia","924109870","4508946    ","050","00","3","5","51007","51","007",11400,11320,80,49,31
"Amherst County","Amherst County, Virginia","1230698046","9331310    ","050","00","3","5","51009","51","009",31894,31506,388,108,280
"Appomattox County","Appomattox County, Virginia","864242984","2713633    ","050","00","3","5","51011","51","011",13705,13517,188,84,104
"Arlington County","Arlington County, Virginia","67002719","243499     ","050","00","3","5","51013","51","013",189453,136760,52693,14393,38300
"Augusta County","Augusta County, Virginia","2513232084","1475781    ","050","00","3","5","51015","51","015",65615,64690,925,384,541
"Bath County","Bath County, Virginia","1377518496","6995988    ","050","00","3","5","51017","51","017",5048,4832,216,35,181
"Bedford County","Bedford County, Virginia","1954149028","38212112   ","050","00","3","5","51019","51","019",60371,59273,1098,635,463
"Bland County","Bland County, Virginia","928947101","163357     ","050","00","3","5","51021","51","021",6871,6815,56,43,13
"Botetourt County","Botetourt County, Virginia","1405475601","8489695    ","050","00","3","5","51023","51","023",30496,30207,289,182,107
"Brunswick County","Brunswick County, Virginia","1466295843","8367122    ","050","00","3","5","51025","51","025",18419,18289,130,29,101
"Buchanan County","Buchanan County, Virginia","1305046130","0          ","050","00","3","5","51027","51","027",26978,26901,77,35,42
"Buckingham County","Buckingham County, Virginia","1504412801","7004144    ","050","00","3","5","51029","51","029",15623,15505,118,58,60
"Campbell County","Campbell County, Virginia","1306603008","7199283    ","050","00","3","5","51031","51","031",51078,50491,587,278,309
"Caroline County","Caroline County, Virginia","1379231031","16477020   ","050","00","3","5","51033","51","033",22121,21739,382,181,201
"Carroll County","Carroll County, Virginia","1233711806","3377059    ","050","00","3","5","51035","51","035",29245,28990,255,124,131
"Charles City County","Charles City County, Virginia","473350245","55568887   ","050","00","3","5","51036","51","036",6926,6839,87,42,45
"Charlotte County","Charlotte County, Virginia","1230231294","6345257    ","050","00","3","5","51037","51","037",12472,12372,100,26,74
"Chesterfield County","Chesterfield County, Virginia","1102697023","29096922   ","050","00","3","5","51041","51","041",259903,246380,13523,6444,7079
"Clarke County","Clarke County, Virginia","457434570","4063485    ","050","00","3","5","51043","51","043",12652,12340,312,151,161
"Craig County","Craig County, Virginia","856275736","11966      ","050","00","3","5","51045","51","045",5091,5075,16,13,3
"Culpeper County","Culpeper County, Virginia","986792161","3298513    ","050","00","3","5","51047","51","047",34262,33069,1193,406,787
"Cumberland County","Cumberland County, Virginia","772974938","3321491    ","050","00","3","5","51049","51","049",9017,8899,118,32,86
"Dickenson County","Dickenson County, Virginia","859135761","4949340    ","050","00","3","5","51051","51","051",16395,16364,31,24,7
"Dinwiddie County","Dinwiddie County, Virginia","1304510610","8564754    ","050","00","3","5","51053","51","053",24533,24194,339,172,167
"Essex County","Essex County, Virginia","667609556","72887926   ","050","00","3","5","51057","51","057",9989,9849,140,67,73
"Fairfax County","Fairfax County, Virginia","1023161078","29957688   ","050","00","3","5","51059","51","059",969749,732072,237677,98601,139076
"Fauquier County","Fauquier County, Virginia","1682715648","4455545    ","050","00","3","5","51061","51","061",55139,53157,1982,927,1055
"Floyd County","Floyd County, Virginia","987342741","35473      ","050","00","3","5","51063","51","063",13874,13663,211,66,145
"Fluvanna County","Fluvanna County, Virginia","744285127","7345205    ","050","00","3","5","51065","51","065",20047,19578,469,226,243
"Franklin County","Franklin County, Virginia","1792488548","50442115   ","050","00","3","5","51067","51","067",47286,46647,639,430,209
"Frederick County","Frederick County, Virginia","1073876718","2579453    ","050","00","3","5","51069","51","069",59209,57803,1406,594,812
"Giles County","Giles County, Virginia","925476873","7954094    ","050","00","3","5","51071","51","071",16657,16532,125,68,57
"Gloucester County","Gloucester County, Virginia","561021730","184887838  ","050","00","3","5","51073","51","073",34780,34127,653,356,297
"Goochland County","Goochland County, Virginia","736665799","14394818   ","050","00","3","5","51075","51","075",16863,16532,331,162,169
"Grayson County","Grayson County, Virginia","1146428475","8455638    ","050","00","3","5","51077","51","077",17917,17705,212,63,149
"Greene County","Greene County, Virginia","405539081","997890     ","050","00","3","5","51079","51","079",15244,14994,250,109,141
"Greensville County","Greensville County, Virginia","765187311","3537822    ","050","00","3","5","51081","51","081",11560,11529,31,19,12
"Halifax County","Halifax County, Virginia","2121966427","26595592   ","050","00","3","5","51083","51","083",37355,36967,388,147,241
"Hanover County","Hanover County, Virginia","1224232801","3632588    ","050","00","3","5","51085","51","085",86320,84793,1527,792,735
"Henrico County","Henrico County, Virginia","616572847","16941010   ","050","00","3","5","51087","51","087",262300,244835,17465,7215,10250
"Henry County","Henry County, Virginia","990285977","5273512    ","050","00","3","5","51089","51","089",57930,56342,1588,207,1381
"Highland County","Highland County, Virginia","1077063621","0          ","050","00","3","5","51091","51","091",2536,2527,9,9,0
"Isle of Wight County","Isle of Wight County, Virginia","818090601","121454392  ","050","00","3","5","51093","51","093",29728,29393,335,203,132
"James City County","James City County, Virginia","370166104","95275662   ","050","00","3","5","51095","51","095",48102,46109,1993,1116,877
"King and Queen County","King and Queen County, Virginia","819120355","26067118   ","050","00","3","5","51097","51","097",6630,6572,58,36,22
"King George County","King George County, Virginia","466193629","20187158   ","050","00","3","5","51099","51","099",16803,16578,225,106,119
"King William County","King William County, Virginia","713367538","26474929   ","050","00","3","5","51101","51","101",13146,12984,162,48,114
"Lancaster County","Lancaster County, Virginia","344839438","254347971  ","050","00","3","5","51103","51","103",11567,11366,201,112,89
"Lee County","Lee County, Virginia","1132173806","473905     ","050","00","3","5","51105","51","105",23589,23481,108,51,57
"Loudoun County","Loudoun County, Virginia","1346408615","3236968    ","050","00","3","5","51107","51","107",169599,150483,19116,7998,11118
"Louisa County","Louisa County, Virginia","1287582756","35352959   ","050","00","3","5","51109","51","109",25627,25297,330,197,133
"Lunenburg County","Lunenburg County, Virginia","1118105054","1749309    ","050","00","3","5","51111","51","111",13146,12983,163,42,121
"Madison County","Madison County, Virginia","832477500","937905     ","050","00","3","5","51113","51","113",12520,12241,279,104,175
"Mathews County","Mathews County, Virginia","221921485","430663695  ","050","00","3","5","51115","51","115",9207,9009,198,139,59
"Mecklenburg County","Mecklenburg County, Virginia","1615980269","143370072  ","050","00","3","5","51117","51","117",32380,31856,524,191,333
"Middlesex County","Middlesex County, Virginia","337470952","208378526  ","050","00","3","5","51119","51","119",9932,9724,208,100,108
"Montgomery County","Montgomery County, Virginia","1005481673","3124565    ","050","00","3","5","51121","51","121",83629,78816,4813,1192,3621
"Nelson County","Nelson County, Virginia","1223392987","5060260    ","050","00","3","5","51125","51","125",14445,14174,271,183,88
"New Kent County","New Kent County, Virginia","542722137","36090072   ","050","00","3","5","51127","51","127",13462,13347,115,77,38
"Northampton County","Northampton County, Virginia","537097052","1522829623 ","050","00","3","5","51131","51","131",13093,12646,447,132,315
"Northumberland County","Northumberland County, Virginia","498059931","241809705  ","050","00","3","5","51133","51","133",12259,12065,194,122,72
"Nottoway County","Nottoway County, Virginia","814945772","3753158    ","050","00","3","5","51135","51","135",15725,15499,226,57,169
"Orange County","Orange County, Virginia","885008655","4412804    ","050","00","3","5","51137","51","137",25881,25401,480,216,264
"Page County","Page County, Virginia","805810173","7685321    ","050","00","3","5","51139","51","139",23177,22825,352,200,152
"Patrick County","Patrick County, Virginia","1251334788","7050380    ","050","00","3","5","51141","51","141",19407,19125,282,67,215
"Pittsylvania County","Pittsylvania County, Virginia","2514256676","19206311   ","050","00","3","5","51143","51","143",61745,61110,635,186,449
"Powhatan County","Powhatan County, Virginia","676706853","2907626    ","050","00","3","5","51145","51","145",22377,22051,326,120,206
"Prince Edward County","Prince Edward County, Virginia","913652419","2813261    ","050","00","3","5","51147","51","147",19720,19449,271,145,126
"Prince George County","Prince George County, Virginia","687943634","42031732   ","050","00","3","5","51149","51","149",33047,31544,1503,670,833
"Prince William County","Prince William County, Virginia","874855263","27399358   ","050","00","3","5","51153","51","153",280813,248627,32186,13391,18795
"Pulaski County","Pulaski County, Virginia","830262288","23375089   ","050","00","3","5","51155","51","155",35127,34911,216,139,77
"Rappahannock County","Rappahannock County, Virginia","690419837","672567     ","050","00","3","5","51157","51","157",6983,6760,223,88,135
"Richmond County","Richmond County, Virginia","495873585","64541178   ","050","00","3","5","51159","51","159",8809,8644,165,51,114
"Roanoke County","Roanoke County, Virginia","649738871","461376     ","050","00","3","5","51161","51","161",85778,83147,2631,1231,1400
"Rockbridge County","Rockbridge County, Virginia","1553026103","3499935    ","050","00","3","5","51163","51","163",20808,20392,416,211,205
"Rockingham County","Rockingham County, Virginia","2204468897","5554653    ","050","00","3","5","51165","51","165",67725,65502,2223,609,1614
"Russell County","Russell County, Virginia","1229359383","5458952    ","050","00","3","5","51167","51","167",30308,30196,112,33,79
"Scott County","Scott County, Virginia","1389736255","5306693    ","050","00","3","5","51169","51","169",23403,23332,71,28,43
"Shenandoah County","Shenandoah County, Virginia","1326604360","836222     ","050","00","3","5","51171","51","171",35075,33995,1080,398,682
"Smyth County","Smyth County, Virginia","1170900626","565693     ","050","00","3","5","51173","51","173",33081,32922,159,105,54
"Southampton County","Southampton County, Virginia","1552841242","7244547    ","050","00","3","5","51175","51","175",17482,17431,51,39,12
"Spotsylvania County","Spotsylvania County, Virginia","1038226922","29547326   ","050","00","3","5","51177","51","177",90395,87478,2917,1736,1181
"Stafford County","Stafford County, Virginia","700205624","24848968   ","050","00","3","5","51179","51","179",92446,88733,3713,2404,1309
"Surry County","Surry County, Virginia","722837207","80851177   ","050","00","3","5","51181","51","181",6829,6796,33,23,10
"Sussex County","Sussex County, Virginia","1270983449","5442975    ","050","00","3","5","51183","51","183",12504,12385,119,44,75
"Tazewell County","Tazewell County, Virginia","1346127553","383086     ","050","00","3","5","51185","51","185",44598,44167,431,250,181
"Warren County","Warren County, Virginia","553475290","6801692    ","050","00","3","5","51187","51","187",31584,30907,677,396,281
"Washington County","Washington County, Virginia","1457801914","8083506    ","050","00","3","5","51191","51","191",51103,50633,470,144,326
"Westmoreland County","Westmoreland County, Virginia","593575171","60760773   ","050","00","3","5","51193","51","193",16718,16206,512,304,208
"Wise County","Wise County, Virginia","1046464808","3053391    ","050","00","3","5","51195","51","195",40123,39940,183,87,96
"Wythe County","Wythe County, Virginia","1199792453","3556294    ","050","00","3","5","51197","51","197",27599,27459,140,61,79
"York County","York County, Virginia","273631204","284562332  ","050","00","3","5","51199","51","199",56297,53366,2931,1787,1144
"Alexandria city","Alexandria city, Virginia","39310427","595095     ","050","00","3","5","51510","51","510",128283,95683,32600,9248,23352
"Bedford city","Bedford city, Virginia","17839806","33230      ","050","00","3","5","51515","51","515",6299,6201,98,86,12
"Bristol city","Bristol city, Virginia","33408015","688883     ","050","00","3","5","51520","51","520",17367,17116,251,140,111
"Buena Vista city","Buena Vista city, Virginia","17691506","0          ","050","00","3","5","51530","51","530",6349,6316,33,23,10
"Charlottesville city","Charlottesville city, Virginia","26579341","0          ","050","00","3","5","51540","51","540",45049,41942,3107,1017,2090
"Chesapeake city","Chesapeake city, Virginia","882457445","26367516   ","050","00","3","5","51550","51","550",199184,193213,5971,3627,2344
"Clifton Forge city","Clifton Forge city, Virginia","8006155","11261      ","050","00","3","5","51560","51","560",4289,4278,11,11,0
"Colonial Heights city","Colonial Heights city, Virginia","19361816","802324     ","050","00","3","5","51570","51","570",16897,16061,836,528,308
"Covington city","Covington city, Virginia","14689470","0          ","050","00","3","5","51580","51","580",6303,6155,148,45,103
"Danville city","Danville city, Virginia","111527387","2269642    ","050","00","3","5","51590","51","590",48411,47711,700,277,423
"Emporia city","Emporia city, Virginia","17852615","191800     ","050","00","3","5","51595","51","595",5665,5482,183,47,136
"Fairfax city","Fairfax city, Virginia","16343135","0          ","050","00","3","5","51600","51","600",21498,16047,5451,1906,3545
"Falls Church city","Falls Church city, Virginia","5143012","0          ","050","00","3","5","51610","51","610",10377,8710,1667,706,961
"Franklin city","Franklin city, Virginia","21633451","121516     ","050","00","3","5","51620","51","620",8346,8284,62,25,37
"Fredericksburg city","Fredericksburg city, Virginia","27240815","11569      ","050","00","3","5","51630","51","630",19279,18282,997,319,678
"Galax city","Galax city, Virginia","21311140","0          ","050","00","3","5","51640","51","640",6837,6249,588,34,554
"Hampton city","Hampton city, Virginia","134112964","218719814  ","050","00","3","5","51650","51","650",146437,140659,5778,3335,2443
"Harrisonburg city","Harrisonburg city, Virginia","45483574","75836      ","050","00","3","5","51660","51","660",40468,36735,3733,666,3067
"Hopewell city","Hopewell city, Virginia","26530144","1503140    ","050","00","3","5","51670","51","670",22354,21919,435,260,175
"Lexington city","Lexington city, Virginia","6458555","0          ","050","00","3","5","51678","51","678",6867,6593,274,146,128
"Lynchburg city","Lynchburg city, Virginia","127921739","947003     ","050","00","3","5","51680","51","680",65269,63196,2073,754,1319
"Manassas city","Manassas city, Virginia","25727953","57532      ","050","00","3","5","51683","51","683",35135,30162,4973,1348,3625
"Manassas Park city","Manassas Park city, Virginia","6454537","0          ","050","00","3","5","51685","51","685",10290,8747,1543,422,1121
"Martinsville city","Martinsville city, Virginia","28375210","134337     ","050","00","3","5","51690","51","690",15416,15004,412,82,330
"Newport News city","Newport News city, Virginia","176881042","131458568  ","050","00","3","5","51700","51","700",180150,171540,8610,4540,4070
"Norfolk city","Norfolk city, Virginia","139155107","110271113  ","050","00","3","5","51710","51","710",234403,222769,11634,5675,5959
"Norton city","Norton city, Virginia","19501536","0          ","050","00","3","5","51720","51","720",3904,3861,43,12,31
"Petersburg city","Petersburg city, Virginia","59260966","789462     ","050","00","3","5","51730","51","730",33740,32971,769,433,336
"Poquoson city","Poquoson city, Virginia","40186651","162933240  ","050","00","3","5","51735","51","735",11566,11226,340,238,102
"Portsmouth city","Portsmouth city, Virginia","85885150","34863486   ","050","00","3","5","51740","51","740",100565,98970,1595,879,716
"Radford city","Radford city, Virginia","25429628","961866     ","050","00","3","5","51750","51","750",15859,15460,399,189,210
"Richmond city","Richmond city, Virginia","155581363","6418229    ","050","00","3","5","51760","51","760",197790,190147,7643,2715,4928
"Roanoke city","Roanoke city, Virginia","111070256","71960      ","050","00","3","5","51770","51","770",94911,92007,2904,835,2069
"Salem city","Salem city, Virginia","37783681","0          ","050","00","3","5","51775","51","775",24747,24224,523,288,235
"Staunton city","Staunton city, Virginia","51043823","0          ","050","00","3","5","51790","51","790",23853,23379,474,308,166
"Suffolk city","Suffolk city, Virginia","1036048206","75234666   ","050","00","3","5","51800","51","800",63677,62497,1180,683,497
"Virginia Beach city","Virginia Beach city, Virginia","643073238","644994920  ","050","00","3","5","51810","51","810",425257,396981,28276,16696,11580
"Waynesboro city","Waynesboro city, Virginia","39783124","49217      ","050","00","3","5","51820","51","820",19520,19049,471,178,293
"Williamsburg city","Williamsburg city, Virginia","22131351","334423     ","050","00","3","5","51830","51","830",11998,11376,622,253,369
"Winchester city","Winchester city, Virginia","24176117","0          ","050","00","3","5","51840","51","840",23585,21981,1604,299,1305
"Adams County","Adams County, Washington","4985625808","12242664   ","050","00","4","9","53001","53","001",16428,12664,3764,903,2861
"Asotin County","Asotin County, Washington","1645531749","13837868   ","050","00","4","9","53003","53","003",20551,20177,374,230,144
"Benton County","Benton County, Washington","4410986706","147711486  ","050","00","4","9","53005","53","005",142475,130424,12051,4230,7821
"Chelan County","Chelan County, Washington","7566304813","187133390  ","050","00","4","9","53007","53","007",66616,58008,8608,2434,6174
"Clallam County","Clallam County, Washington","4505160719","2410998360 ","050","00","4","9","53009","53","009",64525,61648,2877,1675,1202
"Clark County","Clark County, Washington","1627086954","72502560   ","050","00","4","9","53011","53","011",345238,315881,29357,10146,19211
"Columbia County","Columbia County, Washington","2250218881","12210833   ","050","00","4","9","53013","53","013",4064,3935,129,68,61
"Cowlitz County","Cowlitz County, Washington","2949072393","71715831   ","050","00","4","9","53015","53","015",92948,89496,3452,1478,1974
"Douglas County","Douglas County, Washington","4715142292","72948216   ","050","00","4","9","53017","53","017",32603,28201,4402,1172,3230
"Ferry County","Ferry County, Washington","5708287311","138508988  ","050","00","4","9","53019","53","019",7260,7079,181,93,88
"Franklin County","Franklin County, Washington","3217805431","59434923   ","050","00","4","9","53021","53","021",49347,36916,12431,2522,9909
"Garfield County","Garfield County, Washington","1840310422","19794402   ","050","00","4","9","53023","53","023",2397,2374,23,16,7
"Grant County","Grant County, Washington","6943915456","285498298  ","050","00","4","9","53025","53","025",74698,61895,12803,2574,10229
"Grays Harbor County","Grays Harbor County, Washington","4964713992","796559594  ","050","00","4","9","53027","53","027",67194,64396,2798,1037,1761
"Island County","Island County, Washington","539840486","800184622  ","050","00","4","9","53029","53","029",71558,66945,4613,2784,1829
"Jefferson County","Jefferson County, Washington","4698834779","956464956  ","050","00","4","9","53031","53","031",25953,24913,1040,704,336
"King County","King County, Washington","5506429437","467451370  ","050","00","4","9","53033","53","033",1737034,1468749,268285,118436,149849
"Kitsap County","Kitsap County, Washington","1025567312","440320847  ","050","00","4","9","53035","53","035",231969,218789,13180,8094,5086
"Kittitas County","Kittitas County, Washington","5949685399","93049106   ","050","00","4","9","53037","53","037",33362,31582,1780,620,1160
"Klickitat County","Klickitat County, Washington","4849426459","82369002   ","050","00","4","9","53039","53","039",19161,18003,1158,341,817
"Lewis County","Lewis County, Washington","6235751476","74145249   ","050","00","4","9","53041","53","041",68600,65801,2799,972,1827
"Lincoln County","Lincoln County, Washington","5985994704","73828961   ","050","00","4","9","53043","53","043",10184,10061,123,90,33
"Mason County","Mason County, Washington","2489125299","233033245  ","050","00","4","9","53045","53","045",49405,47230,2175,1057,1118
"Okanogan County","Okanogan County, Washington","13644228149","121969271  ","050","00","4","9","53047","53","047",39564,35520,4044,948,3096
"Pacific County","Pacific County, Washington","2416384456","752453525  ","050","00","4","9","53049","53","049",20984,19726,1258,543,715
"Pend Oreille County","Pend Oreille County, Washington","3626675932","64874635   ","050","00","4","9","53051","53","051",11732,11493,239,133,106
"Pierce County","Pierce County, Washington","4348366146","330437071  ","050","00","4","9","53053","53","053",700820,644295,56525,28370,28155
"San Juan County","San Juan County, Washington","453048860","1155515756 ","050","00","4","9","53055","53","055",14077,13240,837,507,330
"Skagit County","Skagit County, Washington","4493987456","480001117  ","050","00","4","9","53057","53","057",102979,93886,9093,2985,6108
"Skamania County","Skamania County, Washington","4290148847","71017875   ","050","00","4","9","53059","53","059",9872,9525,347,159,188
"Snohomish County","Snohomish County, Washington","5410645131","278024082  ","050","00","4","9","53061","53","061",606024,547010,59014,27587,31427
"Spokane County","Spokane County, Washington","4567796041","44250985   ","050","00","4","9","53063","53","063",417939,399228,18711,8051,10660
"Stevens County","Stevens County, Washington","6418768059","161447544  ","050","00","4","9","53065","53","065",40066,39112,954,521,433
"Thurston County","Thurston County, Washington","1882977071","120732807  ","050","00","4","9","53067","53","067",207355,194617,12738,7094,5644
"Wahkiakum County","Wahkiakum County, Washington","684382219","58134623   ","050","00","4","9","53069","53","069",3824,3774,50,35,15
"Walla Walla County","Walla Walla County, Washington","3290593151","74436368   ","050","00","4","9","53071","53","071",55180,49974,5206,1680,3526
"Whatcom County","Whatcom County, Washington","5489566267","994607077  ","050","00","4","9","53073","53","073",166814,150472,16342,6583,9759
"Whitman County","Whitman County, Washington","5592749373","47210352   ","050","00","4","9","53075","53","075",40740,37619,3121,851,2270
"Yakima County","Yakima County, Washington","11127183346","39827088   ","050","00","4","9","53077","53","077",222581,185006,37575,9925,27650
"Barbour County","Barbour County, West Virginia","882637518","5088612    ","050","00","3","5","54001","54","001",15557,15472,85,45,40
"Berkeley County","Berkeley County, West Virginia","831746334","1134871    ","050","00","3","5","54003","54","003",75905,74617,1288,700,588
"Boone County","Boone County, West Virginia","1302723667","509062     ","050","00","3","5","54005","54","005",25535,25440,95,48,47
"Braxton County","Braxton County, West Virginia","1329906592","6957875    ","050","00","3","5","54007","54","007",14702,14678,24,20,4
"Brooke County","Brooke County, West Virginia","230115590","8832451    ","050","00","3","5","54009","54","009",25447,25159,288,221,67
"Cabell County","Cabell County, West Virginia","729323502","16656567   ","050","00","3","5","54011","54","011",96784,95568,1216,705,511
"Calhoun County","Calhoun County, West Virginia","726809639","40789      ","050","00","3","5","54013","54","013",7582,7535,47,22,25
"Clay County","Clay County, West Virginia","886809002","3681552    ","050","00","3","5","54015","54","015",10330,10323,7,7,0
"Doddridge County","Doddridge County, West Virginia","829918475","127235     ","050","00","3","5","54017","54","017",7403,7360,43,27,16
"Fayette County","Fayette County, West Virginia","1719568475","11476697   ","050","00","3","5","54019","54","019",47579,47221,358,184,174
"Gilmer County","Gilmer County, West Virginia","880712528","59977      ","050","00","3","5","54021","54","021",7160,7089,71,28,43
"Grant County","Grant County, West Virginia","1235964455","7732397    ","050","00","3","5","54023","54","023",11299,11247,52,35,17
"Greenbrier County","Greenbrier County, West Virginia","2645045348","8218821    ","050","00","3","5","54025","54","025",34453,34249,204,154,50
"Hampshire County","Hampshire County, West Virginia","1662048488","7499199    ","050","00","3","5","54027","54","027",20203,20077,126,73,53
"Hancock County","Hancock County, West Virginia","214505488","14331416   ","050","00","3","5","54029","54","029",32667,32092,575,428,147
"Hardy County","Hardy County, West Virginia","1510980084","2815068    ","050","00","3","5","54031","54","031",12669,12611,58,29,29
"Harrison County","Harrison County, West Virginia","1077544907","1439483    ","050","00","3","5","54033","54","033",68652,67705,947,503,444
"Jackson County","Jackson County, West Virginia","1206394508","15028001   ","050","00","3","5","54035","54","035",28000,27872,128,91,37
"Jefferson County","Jefferson County, West Virginia","542690399","5269449    ","050","00","3","5","54037","54","037",42190,41314,876,383,493
"Kanawha County","Kanawha County, West Virginia","2339013955","20441005   ","050","00","3","5","54039","54","039",200073,197209,2864,1801,1063
"Lewis County","Lewis County, West Virginia","989742200","19709558   ","050","00","3","5","54041","54","041",16919,16829,90,50,40
"Lincoln County","Lincoln County, West Virginia","1132939198","2996878    ","050","00","3","5","54043","54","043",22108,22097,11,4,7
"Logan County","Logan County, West Virginia","1176408753","3619213    ","050","00","3","5","54045","54","045",37710,37516,194,148,46
"McDowell County","McDowell County, West Virginia","1384922530","469176     ","050","00","3","5","54047","54","047",27329,27193,136,88,48
"Marion County","Marion County, West Virginia","802096062","4669902    ","050","00","3","5","54049","54","049",56598,56054,544,335,209
"Marshall County","Marshall County, West Virginia","795111280","13440246   ","050","00","3","5","54051","54","051",35519,35274,245,187,58
"Mason County","Mason County, West Virginia","1118492685","33541007   ","050","00","3","5","54053","54","053",25957,25831,126,49,77
"Mercer County","Mercer County, West Virginia","1088904184","666240     ","050","00","3","5","54055","54","055",62980,62474,506,375,131
"Mineral County","Mineral County, West Virginia","848824658","3618850    ","050","00","3","5","54057","54","057",27078,26917,161,81,80
"Mingo County","Mingo County, West Virginia","1094549032","2674878    ","050","00","3","5","54059","54","059",28253,28173,80,54,26
"Monongalia County","Monongalia County, West Virginia","935397718","12259311   ","050","00","3","5","54061","54","061",81866,78726,3140,1033,2107
"Monroe County","Monroe County, West Virginia","1226013826","766291     ","050","00","3","5","54063","54","063",14583,14514,69,57,12
"Morgan County","Morgan County, West Virginia","593064160","1771849    ","050","00","3","5","54065","54","065",14943,14735,208,103,105
"Nicholas County","Nicholas County, West Virginia","1679948978","14949478   ","050","00","3","5","54067","54","067",26562,26413,149,110,39
"Ohio County","Ohio County, West Virginia","274995745","6939026    ","050","00","3","5","54069","54","069",47427,46789,638,366,272
"Pendleton County","Pendleton County, West Virginia","1807478061","729040     ","050","00","3","5","54071","54","071",8196,8135,61,12,49
"Pleasants County","Pleasants County, West Virginia","338590449","9991223    ","050","00","3","5","54073","54","073",7514,7479,35,14,21
"Pocahontas County","Pocahontas County, West Virginia","2435333867","4033400    ","050","00","3","5","54075","54","075",9131,9075,56,35,21
"Preston County","Preston County, West Virginia","1679152163","7935253    ","050","00","3","5","54077","54","077",29334,29167,167,84,83
"Putnam County","Putnam County, West Virginia","896737259","10798166   ","050","00","3","5","54079","54","079",51589,51059,530,316,214
"Raleigh County","Raleigh County, West Virginia","1571953269","6236280    ","050","00","3","5","54081","54","081",79220,78275,945,442,503
"Randolph County","Randolph County, West Virginia","2692874431","517443     ","050","00","3","5","54083","54","083",28262,28076,186,80,106
"Ritchie County","Ritchie County, West Virginia","1174591010","174158     ","050","00","3","5","54085","54","085",10343,10308,35,26,9
"Roane County","Roane County, West Virginia","1252446456","458747     ","050","00","3","5","54087","54","087",15446,15349,97,44,53
"Summers County","Summers County, West Virginia","935430028","16948156   ","050","00","3","5","54089","54","089",12999,12949,50,16,34
"Taylor County","Taylor County, West Virginia","447502442","7528930    ","050","00","3","5","54091","54","091",16089,15989,100,64,36
"Tucker County","Tucker County, West Virginia","1084871351","5798707    ","050","00","3","5","54093","54","093",7321,7308,13,13,0
"Tyler County","Tyler County, West Virginia","667065491","8126211    ","050","00","3","5","54095","54","095",9592,9565,27,15,12
"Upshur County","Upshur County, West Virginia","918818849","263268     ","050","00","3","5","54097","54","097",23404,23306,98,39,59
"Wayne County","Wayne County, West Virginia","1309995869","16568778   ","050","00","3","5","54099","54","099",42903,42654,249,95,154
"Webster County","Webster County, West Virginia","1439951547","457581     ","050","00","3","5","54101","54","101",9719,9681,38,25,13
"Wetzel County","Wetzel County, West Virginia","930380031","5553393    ","050","00","3","5","54103","54","103",17693,17626,67,42,25
"Wirt County","Wirt County, West Virginia","603434723","4780499    ","050","00","3","5","54105","54","105",5873,5854,19,2,17
"Wood County","Wood County, West Virginia","951285178","24980854   ","050","00","3","5","54107","54","107",87986,87060,926,520,406
"Wyoming County","Wyoming County, West Virginia","1297264569","2444620    ","050","00","3","5","54109","54","109",25708,25666,42,18,24
"Adams County","Adams County, Wisconsin","1677635648","105609038  ","050","00","2","3","55001","55","001",18643,18222,421,272,149
"Ashland County","Ashland County, Wisconsin","2703488452","3237251867 ","050","00","2","3","55003","55","003",16866,16696,170,69,101
"Barron County","Barron County, Wisconsin","2234756396","70388650   ","050","00","2","3","55005","55","005",44963,44435,528,248,280
"Bayfield County","Bayfield County, Wisconsin","3823465864","1464066885 ","050","00","2","3","55007","55","007",15013,14836,177,117,60
"Brown County","Brown County, Wisconsin","1369262916","224680408  ","050","00","2","3","55009","55","009",226778,217864,8914,2192,6722
"Buffalo County","Buffalo County, Wisconsin","1772776054","65037656   ","050","00","2","3","55011","55","011",13804,13723,81,53,28
"Burnett County","Burnett County, Wisconsin","2127728944","152446387  ","050","00","2","3","55013","55","013",15674,15480,194,104,90
"Calumet County","Calumet County, Wisconsin","828379681","199915070  ","050","00","2","3","55015","55","015",40631,39777,854,279,575
"Chippewa County","Chippewa County, Wisconsin","2617012316","79998028   ","050","00","2","3","55017","55","017",55195,54675,520,270,250
"Clark County","Clark County, Wisconsin","3148480839","8921298    ","050","00","2","3","55019","55","019",33557,33157,400,189,211
"Columbia County","Columbia County, Wisconsin","2004108661","56757045   ","050","00","2","3","55021","55","021",52468,51775,693,293,400
"Crawford County","Crawford County, Wisconsin","1483261703","68714517   ","050","00","2","3","55023","55","023",17243,17121,122,94,28
"Dane County","Dane County, Wisconsin","3112893194","94332123   ","050","00","2","3","55025","55","025",426526,399740,26786,7822,18964
"Dodge County","Dodge County, Wisconsin","2285097125","63990382   ","050","00","2","3","55027","55","027",85897,84517,1380,685,695
"Door County","Door County, Wisconsin","1250235648","4887590577 ","050","00","2","3","55029","55","029",27961,27538,423,285,138
"Douglas County","Douglas County, Wisconsin","3390640586","442321302  ","050","00","2","3","55031","55","031",43287,42596,691,391,300
"Dunn County","Dunn County, Wisconsin","2206739914","30785645   ","050","00","2","3","55033","55","033",39858,39023,835,290,545
"Eau Claire County","Eau Claire County, Wisconsin","1651468668","19798565   ","050","00","2","3","55035","55","035",93142,91050,2092,908,1184
"Florence County","Florence County, Wisconsin","1264000782","24423443   ","050","00","2","3","55037","55","037",5088,5060,28,20,8
"Fond du Lac County","Fond du Lac County, Wisconsin","1872318607","111093288  ","050","00","2","3","55039","55","039",97296,95339,1957,759,1198
"Forest County","Forest County, Wisconsin","2626385922","83767546   ","050","00","2","3","55041","55","041",10024,9914,110,75,35
"Grant County","Grant County, Wisconsin","2972917722","91832341   ","050","00","2","3","55043","55","043",49597,49121,476,242,234
"Green County","Green County, Wisconsin","1512519293","1490591    ","050","00","2","3","55045","55","045",33647,33212,435,270,165
"Green Lake County","Green Lake County, Wisconsin","917585232","67738644   ","050","00","2","3","55047","55","047",19105,18757,348,124,224
"Iowa County","Iowa County, Wisconsin","1975305232","14014711   ","050","00","2","3","55049","55","049",22780,22648,132,90,42
"Iron County","Iron County, Wisconsin","1961221992","419595054  ","050","00","2","3","55051","55","051",6861,6740,121,86,35
"Jackson County","Jackson County, Wisconsin","2557136741","33130570   ","050","00","2","3","55053","55","053",19100,18731,369,145,224
"Jefferson County","Jefferson County, Wisconsin","1442659668","66647984   ","050","00","2","3","55055","55","055",74021,71957,2064,664,1400
"Juneau County","Juneau County, Wisconsin","1988094164","94605398   ","050","00","2","3","55057","55","057",24316,23941,375,199,176
"Kenosha County","Kenosha County, Wisconsin","706617325","1247032199 ","050","00","2","3","55059","55","059",149577,142433,7144,3486,3658
"Kewaunee County","Kewaunee County, Wisconsin","887431283","1921473328 ","050","00","2","3","55061","55","061",20187,19996,191,75,116
"La Crosse County","La Crosse County, Wisconsin","1172593119","70383389   ","050","00","2","3","55063","55","063",107120,104414,2706,1370,1336
"Lafayette County","Lafayette County, Wisconsin","1640932988","2580978    ","050","00","2","3","55065","55","065",16137,16014,123,67,56
"Langlade County","Langlade County, Wisconsin","2260208911","39380464   ","050","00","2","3","55067","55","067",20740,20535,205,106,99
"Lincoln County","Lincoln County, Wisconsin","2287734397","61512210   ","050","00","2","3","55069","55","069",29641,29174,467,250,217
"Manitowoc County","Manitowoc County, Wisconsin","1532059257","2337056569 ","050","00","2","3","55071","55","071",82887,80948,1939,565,1374
"Marathon County","Marathon County, Wisconsin","4001432497","80754105   ","050","00","2","3","55073","55","073",125834,121444,4390,1539,2851
"Marinette County","Marinette County, Wisconsin","3630534095","384137988  ","050","00","2","3","55075","55","075",43384,42844,540,332,208
"Marquette County","Marquette County, Wisconsin","1179702527","23144792   ","050","00","2","3","55077","55","077",15832,15602,230,158,72
"Menominee County","Menominee County, Wisconsin","927111397","18200620   ","050","00","2","3","55078","55","078",4562,4441,121,47,74
"Milwaukee County","Milwaukee County, Wisconsin","625636083","2455678596 ","050","00","2","3","55079","55","079",940164,876516,63648,23894,39754
"Monroe County","Monroe County, Wisconsin","2332974625","19488875   ","050","00","2","3","55081","55","081",40899,40148,751,283,468
"Oconto County","Oconto County, Wisconsin","2584721481","391280687  ","050","00","2","3","55083","55","083",35634,35402,232,157,75
"Oneida County","Oneida County, Wisconsin","2912438031","288467499  ","050","00","2","3","55085","55","085",36776,36395,381,270,111
"Outagamie County","Outagamie County, Wisconsin","1658475643","10503053   ","050","00","2","3","55087","55","087",160971,155914,5057,1623,3434
"Ozaukee County","Ozaukee County, Wisconsin","600736387","2290213743 ","050","00","2","3","55089","55","089",82317,79598,2719,1397,1322
"Pepin County","Pepin County, Wisconsin","601610420","42476877   ","050","00","2","3","55091","55","091",7213,7171,42,15,27
"Pierce County","Pierce County, Wisconsin","1493092474","39105584   ","050","00","2","3","55093","55","093",36804,36443,361,164,197
"Polk County","Polk County, Wisconsin","2375723772","101029163  ","050","00","2","3","55095","55","095",41319,40914,405,220,185
"Portage County","Portage County, Wisconsin","2088335187","42611754   ","050","00","2","3","55097","55","097",67182,65724,1458,624,834
"Price County","Price County, Wisconsin","3244108156","67003280   ","050","00","2","3","55099","55","099",15822,15724,98,66,32
"Racine County","Racine County, Wisconsin","862717511","1188301229 ","050","00","2","3","55101","55","101",188831,181121,7710,3487,4223
"Richland County","Richland County, Wisconsin","1518245431","8248415    ","050","00","2","3","55103","55","103",17924,17741,183,98,85
"Rock County","Rock County, Wisconsin","1866004683","14835453   ","050","00","2","3","55105","55","105",152307,147259,5048,1660,3388
"Rusk County","Rusk County, Wisconsin","2364989771","46014711   ","050","00","2","3","55107","55","107",15347,15091,256,109,147
"St. Croix County","St. Croix County, Wisconsin","1869516594","36217078   ","050","00","2","3","55109","55","109",63155,62463,692,346,346
"Sauk County","Sauk County, Wisconsin","2169451473","27960116   ","050","00","2","3","55111","55","111",55225,54157,1068,496,572
"Sawyer County","Sawyer County, Wisconsin","3254107281","243207390  ","050","00","2","3","55113","55","113",16196,15933,263,199,64
"Shawano County","Shawano County, Wisconsin","2311587903","43572484   ","050","00","2","3","55115","55","115",40664,40256,408,164,244
"Sheboygan County","Sheboygan County, Wisconsin","1330296514","1961500967 ","050","00","2","3","55117","55","117",112646,107829,4817,1541,3276
"Taylor County","Taylor County, Wisconsin","2524888374","24938723   ","050","00","2","3","55119","55","119",19680,19509,171,95,76
"Trempealeau County","Trempealeau County, Wisconsin","1901266149","20465932   ","050","00","2","3","55121","55","121",27010,26806,204,101,103
"Vernon County","Vernon County, Wisconsin","2058709676","55791573   ","050","00","2","3","55123","55","123",28056,27820,236,151,85
"Vilas County","Vilas County, Wisconsin","2262916969","373291621  ","050","00","2","3","55125","55","125",21033,20524,509,373,136
"Walworth County","Walworth County, Wisconsin","1438254026","54883886   ","050","00","2","3","55127","55","127",93759,88723,5036,2046,2990
"Washburn County","Washburn County, Wisconsin","2097069451","112335975  ","050","00","2","3","55129","55","129",16036,15877,159,108,51
"Washington County","Washington County, Wisconsin","1115807705","13131514   ","050","00","2","3","55131","55","131",117493,115303,2190,1167,1023
"Waukesha County","Waukesha County, Wisconsin","1438933838","64505883   ","050","00","2","3","55133","55","133",360767,347750,13017,7241,5776
"Waupaca County","Waupaca County, Wisconsin","1945324530","36872092   ","050","00","2","3","55135","55","135",51731,51222,509,309,200
"Waushara County","Waushara County, Wisconsin","1621420145","29421320   ","050","00","2","3","55137","55","137",23154,22689,465,214,251
"Winnebago County","Winnebago County, Wisconsin","1135926377","362903396  ","050","00","2","3","55139","55","139",156763,152412,4351,1696,2655
"Wood County","Wood County, Wisconsin","2053297501","43193861   ","050","00","2","3","55141","55","141",75555,74000,1555,679,876
"Albany County","Albany County, Wyoming","11066371631","93337328   ","050","00","4","8","56001","56","001",32014,30796,1218,301,917
"Big Horn County","Big Horn County, Wyoming","8124774511","56903828   ","050","00","4","8","56003","56","003",11461,11208,253,88,165
"Campbell County","Campbell County, Wyoming","12423548375","12443945   ","050","00","4","8","56005","56","005",33698,33136,562,264,298
"Carbon County","Carbon County, Wyoming","20450904187","175839496  ","050","00","4","8","56007","56","007",15639,15192,447,202,245
"Converse County","Converse County, Wyoming","11019675593","26882976   ","050","00","4","8","56009","56","009",12052,11828,224,110,114
"Crook County","Crook County, Wyoming","7403716371","30890113   ","050","00","4","8","56011","56","011",5887,5835,52,15,37
"Fremont County","Fremont County, Wyoming","23781972118","216338420  ","050","00","4","8","56013","56","013",35804,35500,304,175,129
"Goshen County","Goshen County, Wyoming","5763558792","17717514   ","050","00","4","8","56015","56","015",12538,12301,237,143,94
"Hot Springs County","Hot Springs County, Wyoming","5190040440","6017747    ","050","00","4","8","56017","56","017",4882,4818,64,52,12
"Johnson County","Johnson County, Wyoming","10790624222","21815458   ","050","00","4","8","56019","56","019",7075,7017,58,31,27
"Laramie County","Laramie County, Wyoming","6956841280","4080587    ","050","00","4","8","56021","56","021",81607,79208,2399,1533,866
"Lincoln County","Lincoln County, Wyoming","10538892638","51584820   ","050","00","4","8","56023","56","023",14573,14375,198,122,76
"Natrona County","Natrona County, Wyoming","13830230221","92810174   ","050","00","4","8","56025","56","025",66533,65336,1197,574,623
"Niobrara County","Niobrara County, Wyoming","6800824221","5403809    ","050","00","4","8","56027","56","027",2407,2390,17,9,8
"Park County","Park County, Wyoming","17980716396","67631424   ","050","00","4","8","56029","56","029",25786,25334,452,296,156
"Platte County","Platte County, Wyoming","5399944444","67255789   ","050","00","4","8","56031","56","031",8807,8671,136,37,99
"Sheridan County","Sheridan County, Wyoming","6535366042","9711553    ","050","00","4","8","56033","56","033",26560,26130,430,212,218
"Sublette County","Sublette County, Wyoming","12645806081","137484047  ","050","00","4","8","56035","56","035",5920,5823,97,61,36
"Sweetwater County","Sweetwater County, Wyoming","27001397855","170594040  ","050","00","4","8","56037","56","037",37613,36581,1032,446,586
"Teton County","Teton County, Wyoming","10380047047","554365295  ","050","00","4","8","56039","56","039",18251,17178,1073,158,915
"Uinta County","Uinta County, Wyoming","5391482930","15275017   ","050","00","4","8","56041","56","041",19742,19240,502,196,306
"Washakie County","Washakie County, Wyoming","5801718291","6967443    ","050","00","4","8","56043","56","043",8289,8087,202,76,126
"Weston County","Weston County, Wyoming","6210418457","5730672    ","050","00","4","8","56045","56","045",6644,6593,51,20,31
"Adjuntas Municipio","Adjuntas Municipio, Puerto Rico","172731389","1082233    ","050","00","9","0","72001","72","001",19143,19081,62,26,36
"Aguada Municipio","Aguada Municipio, Puerto Rico","80100548","37877243   ","050","00","9","0","72003","72","003",42042,41817,225,115,110
"Aguadilla Municipio","Aguadilla Municipio, Puerto Rico","94769885","100931650  ","050","00","9","0","72005","72","005",64685,63928,757,436,321
"Aguas Buenas Municipio","Aguas Buenas Municipio, Puerto Rico","79163735","13681      ","050","00","9","0","72007","72","007",29032,28904,128,52,76
"Aibonito Municipio","Aibonito Municipio, Puerto Rico","81038559","37881      ","050","00","9","0","72009","72","009",26493,26324,169,87,82
"Añasco Municipio","Añasco Municipio, Puerto Rico","101717977","14576764   ","050","00","9","0","72011","72","011",28348,28150,198,92,106
"Arecibo Municipio","Arecibo Municipio, Puerto Rico","326309330","117151658  ","050","00","9","0","72013","72","013",100131,99009,1122,514,608
"Arroyo Municipio","Arroyo Municipio, Puerto Rico","38956324","53346177   ","050","00","9","0","72015","72","015",19117,18921,196,96,100
"Barceloneta Municipio","Barceloneta Municipio, Puerto Rico","48319891","31698997   ","050","00","9","0","72017","72","017",22322,22259,63,34,29
"Barranquitas Municipio","Barranquitas Municipio, Puerto Rico","88626275","27705      ","050","00","9","0","72019","72","019",28909,28820,89,53,36
"Bayamón Municipio","Bayamón Municipio, Puerto Rico","114949736","391576     ","050","00","9","0","72021","72","021",224044,215919,8125,3661,4464
"Cabo Rojo Municipio","Cabo Rojo Municipio, Puerto Rico","182213491","277259001  ","050","00","9","0","72023","72","023",46911,46434,477,275,202
"Caguas Municipio","Caguas Municipio, Puerto Rico","151966842","1031547    ","050","00","9","0","72025","72","025",140502,137940,2562,1034,1528
"Camuy Municipio","Camuy Municipio, Puerto Rico","120242300","40111399   ","050","00","9","0","72027","72","027",35244,34984,260,119,141
"Canóvanas Municipio","Canóvanas Municipio, Puerto Rico","85073802","319066     ","050","00","9","0","72029","72","029",43335,42111,1224,365,859
"Carolina Municipio","Carolina Municipio, Puerto Rico","117399117","38893551   ","050","00","9","0","72031","72","031",186076,174516,11560,5553,6007
"Cataño Municipio","Cataño Municipio, Puerto Rico","12496362","5734792    ","050","00","9","0","72033","72","033",30071,29285,786,332,454
"Cayey Municipio","Cayey Municipio, Puerto Rico","134409845","28791      ","050","00","9","0","72035","72","035",47370,46941,429,151,278
"Ceiba Municipio","Ceiba Municipio, Puerto Rico","75221959","336132204  ","050","00","9","0","72037","72","037",18004,17434,570,143,427
"Ciales Municipio","Ciales Municipio, Puerto Rico","172617091","428000     ","050","00","9","0","72039","72","039",19811,19668,143,60,83
"Cidra Municipio","Cidra Municipio, Puerto Rico","93481502","1086200    ","050","00","9","0","72041","72","041",42753,42520,233,132,101
"Coamo Municipio","Coamo Municipio, Puerto Rico","202132196","17330      ","050","00","9","0","72043","72","043",37597,37452,145,73,72
"Comerío Municipio","Comerío Municipio, Puerto Rico","73530879","333934     ","050","00","9","0","72045","72","045",20002,19922,80,21,59
"Corozal Municipio","Corozal Municipio, Puerto Rico","110303453","6627       ","050","00","9","0","72047","72","047",36867,36706,161,73,88
"Culebra Municipio","Culebra Municipio, Puerto Rico","30091439","407166656  ","050","00","9","0","72049","72","049",1868,1779,89,24,65
"Dorado Municipio","Dorado Municipio, Puerto Rico","60420674","78989110   ","050","00","9","0","72051","72","051",34017,33357,660,243,417
"Fajardo Municipio","Fajardo Municipio, Puerto Rico","77366079","195413922  ","050","00","9","0","72053","72","053",40712,39873,839,427,412
"Florida Municipio","Florida Municipio, Puerto Rico","39352907","11774      ","050","00","9","0","72054","72","054",12367,12329,38,32,6
"Guánica Municipio","Guánica Municipio, Puerto Rico","96110642","109697043  ","050","00","9","0","72055","72","055",21888,21706,182,95,87
"Guayama Municipio","Guayama Municipio, Puerto Rico","168530628","108108484  ","050","00","9","0","72057","72","057",44301,44023,278,154,124
"Guayanilla Municipio","Guayanilla Municipio, Puerto Rico","109716676","56848611   ","050","00","9","0","72059","72","059",23072,23021,51,33,18
"Guaynabo Municipio","Guaynabo Municipio, Puerto Rico","70259405","462548     ","050","00","9","0","72061","72","061",100053,94077,5976,3639,2337
"Gurabo Municipio","Gurabo Municipio, Puerto Rico","72108283","1133710    ","050","00","9","0","72063","72","063",36743,36176,567,308,259
"Hatillo Municipio","Hatillo Municipio, Puerto Rico","108216440","43884134   ","050","00","9","0","72065","72","065",38925,38600,325,162,163
"Hormigueros Municipio","Hormigueros Municipio, Puerto Rico","29330252","0          ","050","00","9","0","72067","72","067",16614,16403,211,96,115
"Humacao Municipio","Humacao Municipio, Puerto Rico","115953866","68972351   ","050","00","9","0","72069","72","069",59035,58231,804,330,474
"Isabela Municipio","Isabela Municipio, Puerto Rico","143392155","94754708   ","050","00","9","0","72071","72","071",44444,44109,335,188,147
"Jayuya Municipio","Jayuya Municipio, Puerto Rico","115483732","0          ","050","00","9","0","72073","72","073",17318,17278,40,18,22
"Juana Díaz Municipio","Juana Díaz Municipio, Puerto Rico","156152398","121077135  ","050","00","9","0","72075","72","075",50531,50225,306,183,123
"Juncos Municipio","Juncos Municipio, Puerto Rico","68857536","31343      ","050","00","9","0","72077","72","077",36452,36172,280,115,165
"Lajas Municipio","Lajas Municipio, Puerto Rico","155664389","106298040  ","050","00","9","0","72079","72","079",26261,26067,194,53,141
"Lares Municipio","Lares Municipio, Puerto Rico","159188026","478304     ","050","00","9","0","72081","72","081",34415,34194,221,51,170
"Las Marías Municipio","Las Marías Municipio, Puerto Rico","120014547","385795     ","050","00","9","0","72083","72","083",11061,10961,100,38,62
"Las Piedras Municipio","Las Piedras Municipio, Puerto Rico","87759040","8267       ","050","00","9","0","72085","72","085",34485,34215,270,115,155
"Loíza Municipio","Loíza Municipio, Puerto Rico","50358594","119827845  ","050","00","9","0","72087","72","087",32537,31986,551,200,351
"Luquillo Municipio","Luquillo Municipio, Puerto Rico","66556821","53678351   ","050","00","9","0","72089","72","089",19817,19480,337,166,171
"Manatí Municipio","Manatí Municipio, Puerto Rico","116974144","66115395   ","050","00","9","0","72091","72","091",45409,44975,434,187,247
"Maricao Municipio","Maricao Municipio, Puerto Rico","94870047","0          ","050","00","9","0","72093","72","093",6449,6394,55,22,33
"Maunabo Municipio","Maunabo Municipio, Puerto Rico","54486451","44575687   ","050","00","9","0","72095","72","095",12741,12681,60,26,34
"Mayagüez Municipio","Mayagüez Municipio, Puerto Rico","201068404","508817268  ","050","00","9","0","72097","72","097",98434,96466,1968,1062,906
"Moca Municipio","Moca Municipio, Puerto Rico","130242672","0          ","050","00","9","0","72099","72","099",39697,39370,327,147,180
"Morovis Municipio","Morovis Municipio, Puerto Rico","100680960","125431     ","050","00","9","0","72101","72","101",29965,29776,189,85,104
"Naguabo Municipio","Naguabo Municipio, Puerto Rico","133899918","53263740   ","050","00","9","0","72103","72","103",23753,23572,181,90,91
"Naranjito Municipio","Naranjito Municipio, Puerto Rico","70326818","1403603    ","050","00","9","0","72105","72","105",29709,29646,63,41,22
"Orocovis Municipio","Orocovis Municipio, Puerto Rico","164439692","442938     ","050","00","9","0","72107","72","107",23844,23778,66,30,36
"Patillas Municipio","Patillas Municipio, Puerto Rico","120941393","74131571   ","050","00","9","0","72109","72","109",20152,20077,75,24,51
"Peñuelas Municipio","Peñuelas Municipio, Puerto Rico","114880458","60655900   ","050","00","9","0","72111","72","111",26719,26562,157,87,70
"Ponce Municipio","Ponce Municipio, Puerto Rico","297126521","204310060  ","050","00","9","0","72113","72","113",186475,184180,2295,1152,1143
"Quebradillas Municipio","Quebradillas Municipio, Puerto Rico","58665080","30210996   ","050","00","9","0","72115","72","115",25450,25233,217,72,145
"Rincón Municipio","Rincón Municipio, Puerto Rico","36987831","103921765  ","050","00","9","0","72117","72","117",14767,14617,150,69,81
"Río Grande Municipio","Río Grande Municipio, Puerto Rico","157281037","74831819   ","050","00","9","0","72119","72","119",52362,51547,815,358,457
"Sabana Grande Municipio","Sabana Grande Municipio, Puerto Rico","92943730","10072      ","050","00","9","0","72121","72","121",25935,25669,266,134,132
"Salinas Municipio","Salinas Municipio, Puerto Rico","179259682","116356142  ","050","00","9","0","72123","72","123",31113,30891,222,181,41
"San Germán Municipio","San Germán Municipio, Puerto Rico","141178142","0          ","050","00","9","0","72125","72","125",37105,36874,231,123,108
"San Juan Municipio","San Juan Municipio, Puerto Rico","123841830","75394315   ","050","00","9","0","72127","72","127",434374,383866,50508,17963,32545
"San Lorenzo Municipio","San Lorenzo Municipio, Puerto Rico","137656489","181589     ","050","00","9","0","72129","72","129",40997,40692,305,141,164
"San Sebastián Municipio","San Sebastián Municipio, Puerto Rico","182525567","1989026    ","050","00","9","0","72131","72","131",44204,43917,287,209,78
"Santa Isabel Municipio","Santa Isabel Municipio, Puerto Rico","88418645","110883878  ","050","00","9","0","72133","72","133",21665,21491,174,114,60
"Toa Alta Municipio","Toa Alta Municipio, Puerto Rico","70880712","515577     ","050","00","9","0","72135","72","135",63929,63006,923,484,439
"Toa Baja Municipio","Toa Baja Municipio, Puerto Rico","59989296","48008525   ","050","00","9","0","72137","72","137",94085,91371,2714,1088,1626
"Trujillo Alto Municipio","Trujillo Alto Municipio, Puerto Rico","53735601","1569585    ","050","00","9","0","72139","72","139",75728,73126,2602,1336,1266
"Utuado Municipio","Utuado Municipio, Puerto Rico","293830968","4003256    ","050","00","9","0","72141","72","141",35336,35201,135,57,78
"Vega Alta Municipio","Vega Alta Municipio, Puerto Rico","71872092","25275342   ","050","00","9","0","72143","72","143",37910,37550,360,133,227
"Vega Baja Municipio","Vega Baja Municipio, Puerto Rico","118858686","57707891   ","050","00","9","0","72145","72","145",61929,61270,659,371,288
"Vieques Municipio","Vieques Municipio, Puerto Rico","131645368","552065201  ","050","00","9","0","72147","72","147",9106,8983,123,57,66
"Villalba Municipio","Villalba Municipio, Puerto Rico","91798136","4164243    ","050","00","9","0","72149","72","149",27913,27815,98,34,64
"Yabucoa Municipio","Yabucoa Municipio, Puerto Rico","143105464","72545348   ","050","00","9","0","72151","72","151",39246,39083,163,72,91
"Yauco Municipio","Yauco Municipio, Puerto Rico","176498982","1600388    ","050","00","9","0","72153","72","153",46384,46043,341,180,161
